category,filename,image_path,roi_id,x1,y1,x2,y2,width,height,area
Action,001.jpg,data/CAT2000/trainSet/Stimuli/Action/001.jpg,ROI_00,702,356,1084,674,382,318,121476
Action,003.jpg,data/CAT2000/trainSet/Stimuli/Action/003.jpg,ROI_00,607,219,1122,709,515,490,252350
Action,003.jpg,data/CAT2000/trainSet/Stimuli/Action/003.jpg,ROI_01,1271,345,1445,586,174,241,41934
Action,005.jpg,data/CAT2000/trainSet/Stimuli/Action/005.jpg,ROI_00,690,334,1072,763,382,429,163878
Action,007.jpg,data/CAT2000/trainSet/Stimuli/Action/007.jpg,ROI_00,1133,269,1337,440,204,171,34884
Action,007.jpg,data/CAT2000/trainSet/Stimuli/Action/007.jpg,ROI_01,797,369,1096,643,299,274,81926
Action,007.jpg,data/CAT2000/trainSet/Stimuli/Action/007.jpg,ROI_02,1119,667,1312,912,193,245,47285
Action,009.jpg,data/CAT2000/trainSet/Stimuli/Action/009.jpg,ROI_00,727,229,1092,651,365,422,154030
Action,011.jpg,data/CAT2000/trainSet/Stimuli/Action/011.jpg,ROI_00,648,124,1070,676,422,552,232944
Action,011.jpg,data/CAT2000/trainSet/Stimuli/Action/011.jpg,ROI_01,517,475,663,609,146,134,19564
Action,013.jpg,data/CAT2000/trainSet/Stimuli/Action/013.jpg,ROI_00,783,1,1083,649,300,648,194400
Action,013.jpg,data/CAT2000/trainSet/Stimuli/Action/013.jpg,ROI_01,848,667,1016,935,168,268,45024
Action,015.jpg,data/CAT2000/trainSet/Stimuli/Action/015.jpg,ROI_00,907,350,1234,869,327,519,169713
Action,017.jpg,data/CAT2000/trainSet/Stimuli/Action/017.jpg,ROI_00,1156,189,1363,432,207,243,50301
Action,017.jpg,data/CAT2000/trainSet/Stimuli/Action/017.jpg,ROI_01,871,409,1131,663,260,254,66040
Action,017.jpg,data/CAT2000/trainSet/Stimuli/Action/017.jpg,ROI_02,992,690,1132,836,140,146,20440
Action,019.jpg,data/CAT2000/trainSet/Stimuli/Action/019.jpg,ROI_00,508,321,1318,684,810,363,294030
Action,019.jpg,data/CAT2000/trainSet/Stimuli/Action/019.jpg,ROI_01,1516,646,1635,722,119,76,9044
Action,021.jpg,data/CAT2000/trainSet/Stimuli/Action/021.jpg,ROI_00,1427,316,1632,486,205,170,34850
Action,021.jpg,data/CAT2000/trainSet/Stimuli/Action/021.jpg,ROI_01,560,342,821,627,261,285,74385
Action,021.jpg,data/CAT2000/trainSet/Stimuli/Action/021.jpg,ROI_02,831,393,1122,753,291,360,104760
Action,023.jpg,data/CAT2000/trainSet/Stimuli/Action/023.jpg,ROI_00,568,416,1121,699,553,283,156499
Action,023.jpg,data/CAT2000/trainSet/Stimuli/Action/023.jpg,ROI_01,1330,841,1570,1052,240,211,50640
Action,025.jpg,data/CAT2000/trainSet/Stimuli/Action/025.jpg,ROI_00,396,305,572,540,176,235,41360
Action,025.jpg,data/CAT2000/trainSet/Stimuli/Action/025.jpg,ROI_01,711,296,1252,689,541,393,212613
Action,027.jpg,data/CAT2000/trainSet/Stimuli/Action/027.jpg,ROI_00,858,120,1162,606,304,486,147744
Action,027.jpg,data/CAT2000/trainSet/Stimuli/Action/027.jpg,ROI_01,675,578,842,775,167,197,32899
Action,027.jpg,data/CAT2000/trainSet/Stimuli/Action/027.jpg,ROI_02,1126,793,1230,902,104,109,11336
Action,027.jpg,data/CAT2000/trainSet/Stimuli/Action/027.jpg,ROI_03,870,825,988,941,118,116,13688
Action,029.jpg,data/CAT2000/trainSet/Stimuli/Action/029.jpg,ROI_00,757,51,1050,337,293,286,83798
Action,029.jpg,data/CAT2000/trainSet/Stimuli/Action/029.jpg,ROI_01,855,404,1192,693,337,289,97393
Action,031.jpg,data/CAT2000/trainSet/Stimuli/Action/031.jpg,ROI_00,1051,80,1132,173,81,93,7533
Action,031.jpg,data/CAT2000/trainSet/Stimuli/Action/031.jpg,ROI_01,1491,56,1659,237,168,181,30408
Action,031.jpg,data/CAT2000/trainSet/Stimuli/Action/031.jpg,ROI_02,753,201,1096,798,343,597,204771
Action,033.jpg,data/CAT2000/trainSet/Stimuli/Action/033.jpg,ROI_00,691,410,1078,813,387,403,155961
Action,035.jpg,data/CAT2000/trainSet/Stimuli/Action/035.jpg,ROI_00,474,190,566,308,92,118,10856
Action,035.jpg,data/CAT2000/trainSet/Stimuli/Action/035.jpg,ROI_01,831,174,1031,357,200,183,36600
Action,035.jpg,data/CAT2000/trainSet/Stimuli/Action/035.jpg,ROI_02,1282,225,1442,390,160,165,26400
Action,035.jpg,data/CAT2000/trainSet/Stimuli/Action/035.jpg,ROI_03,854,426,1108,675,254,249,63246
Action,037.jpg,data/CAT2000/trainSet/Stimuli/Action/037.jpg,ROI_00,841,298,1168,626,327,328,107256
Action,037.jpg,data/CAT2000/trainSet/Stimuli/Action/037.jpg,ROI_01,1243,689,1475,854,232,165,38280
Action,039.jpg,data/CAT2000/trainSet/Stimuli/Action/039.jpg,ROI_00,770,183,1160,681,390,498,194220
Action,039.jpg,data/CAT2000/trainSet/Stimuli/Action/039.jpg,ROI_01,935,926,1056,1040,121,114,13794
Action,041.jpg,data/CAT2000/trainSet/Stimuli/Action/041.jpg,ROI_00,777,304,1050,655,273,351,95823
Action,043.jpg,data/CAT2000/trainSet/Stimuli/Action/043.jpg,ROI_00,807,147,1039,368,232,221,51272
Action,043.jpg,data/CAT2000/trainSet/Stimuli/Action/043.jpg,ROI_01,872,405,1153,664,281,259,72779
Action,043.jpg,data/CAT2000/trainSet/Stimuli/Action/043.jpg,ROI_02,1019,665,1131,762,112,97,10864
Action,045.jpg,data/CAT2000/trainSet/Stimuli/Action/045.jpg,ROI_00,741,302,1099,660,358,358,128164
Action,045.jpg,data/CAT2000/trainSet/Stimuli/Action/045.jpg,ROI_01,793,697,911,827,118,130,15340
Action,047.jpg,data/CAT2000/trainSet/Stimuli/Action/047.jpg,ROI_00,857,255,1123,650,266,395,105070
Action,049.jpg,data/CAT2000/trainSet/Stimuli/Action/049.jpg,ROI_00,869,313,1125,642,256,329,84224
Action,049.jpg,data/CAT2000/trainSet/Stimuli/Action/049.jpg,ROI_01,851,647,1030,886,179,239,42781
Action,051.jpg,data/CAT2000/trainSet/Stimuli/Action/051.jpg,ROI_00,807,223,1299,682,492,459,225828
Action,053.jpg,data/CAT2000/trainSet/Stimuli/Action/053.jpg,ROI_00,865,345,1241,720,376,375,141000
Action,055.jpg,data/CAT2000/trainSet/Stimuli/Action/055.jpg,ROI_00,892,177,1065,381,173,204,35292
Action,055.jpg,data/CAT2000/trainSet/Stimuli/Action/055.jpg,ROI_01,587,227,882,400,295,173,51035
Action,055.jpg,data/CAT2000/trainSet/Stimuli/Action/055.jpg,ROI_02,860,422,1198,645,338,223,75374
Action,055.jpg,data/CAT2000/trainSet/Stimuli/Action/055.jpg,ROI_03,810,671,1050,832,240,161,38640
Action,057.jpg,data/CAT2000/trainSet/Stimuli/Action/057.jpg,ROI_00,715,268,1118,641,403,373,150319
Action,059.jpg,data/CAT2000/trainSet/Stimuli/Action/059.jpg,ROI_00,685,232,778,360,93,128,11904
Action,059.jpg,data/CAT2000/trainSet/Stimuli/Action/059.jpg,ROI_01,858,441,1253,688,395,247,97565
Action,059.jpg,data/CAT2000/trainSet/Stimuli/Action/059.jpg,ROI_02,496,615,633,747,137,132,18084
Action,059.jpg,data/CAT2000/trainSet/Stimuli/Action/059.jpg,ROI_03,924,768,1210,973,286,205,58630
Action,061.jpg,data/CAT2000/trainSet/Stimuli/Action/061.jpg,ROI_00,891,275,1227,834,336,559,187824
Action,063.jpg,data/CAT2000/trainSet/Stimuli/Action/063.jpg,ROI_00,1547,291,1704,426,157,135,21195
Action,063.jpg,data/CAT2000/trainSet/Stimuli/Action/063.jpg,ROI_01,1212,401,1339,531,127,130,16510
Action,063.jpg,data/CAT2000/trainSet/Stimuli/Action/063.jpg,ROI_02,835,362,1022,620,187,258,48246
Action,065.jpg,data/CAT2000/trainSet/Stimuli/Action/065.jpg,ROI_00,783,381,1123,705,340,324,110160
Action,067.jpg,data/CAT2000/trainSet/Stimuli/Action/067.jpg,ROI_00,802,377,1402,643,600,266,159600
Action,069.jpg,data/CAT2000/trainSet/Stimuli/Action/069.jpg,ROI_00,762,133,1142,693,380,560,212800
Action,071.jpg,data/CAT2000/trainSet/Stimuli/Action/071.jpg,ROI_00,1365,387,1508,533,143,146,20878
Action,071.jpg,data/CAT2000/trainSet/Stimuli/Action/071.jpg,ROI_01,766,366,1133,747,367,381,139827
Action,071.jpg,data/CAT2000/trainSet/Stimuli/Action/071.jpg,ROI_02,402,568,525,737,123,169,20787
Action,073.jpg,data/CAT2000/trainSet/Stimuli/Action/073.jpg,ROI_00,780,372,1109,802,329,430,141470
Action,075.jpg,data/CAT2000/trainSet/Stimuli/Action/075.jpg,ROI_00,782,398,1103,688,321,290,93090
Action,075.jpg,data/CAT2000/trainSet/Stimuli/Action/075.jpg,ROI_01,852,693,1096,966,244,273,66612
Action,077.jpg,data/CAT2000/trainSet/Stimuli/Action/077.jpg,ROI_00,870,432,1088,944,218,512,111616
Action,077.jpg,data/CAT2000/trainSet/Stimuli/Action/077.jpg,ROI_01,1299,746,1465,899,166,153,25398
Action,077.jpg,data/CAT2000/trainSet/Stimuli/Action/077.jpg,ROI_02,446,730,671,934,225,204,45900
Action,079.jpg,data/CAT2000/trainSet/Stimuli/Action/079.jpg,ROI_00,713,448,1208,747,495,299,148005
Action,081.jpg,data/CAT2000/trainSet/Stimuli/Action/081.jpg,ROI_00,849,331,1272,755,423,424,179352
Action,081.jpg,data/CAT2000/trainSet/Stimuli/Action/081.jpg,ROI_01,1260,834,1348,942,88,108,9504
Action,083.jpg,data/CAT2000/trainSet/Stimuli/Action/083.jpg,ROI_00,1419,466,1563,732,144,266,38304
Action,083.jpg,data/CAT2000/trainSet/Stimuli/Action/083.jpg,ROI_01,858,435,1158,773,300,338,101400
Action,085.jpg,data/CAT2000/trainSet/Stimuli/Action/085.jpg,ROI_00,494,265,1077,789,583,524,305492
Action,085.jpg,data/CAT2000/trainSet/Stimuli/Action/085.jpg,ROI_01,1167,523,1305,616,138,93,12834
Action,087.jpg,data/CAT2000/trainSet/Stimuli/Action/087.jpg,ROI_00,659,440,1094,898,435,458,199230
Action,089.jpg,data/CAT2000/trainSet/Stimuli/Action/089.jpg,ROI_00,665,385,1099,827,434,442,191828
Action,089.jpg,data/CAT2000/trainSet/Stimuli/Action/089.jpg,ROI_01,1418,626,1583,762,165,136,22440
Action,091.jpg,data/CAT2000/trainSet/Stimuli/Action/091.jpg,ROI_00,848,202,1108,615,260,413,107380
Action,093.jpg,data/CAT2000/trainSet/Stimuli/Action/093.jpg,ROI_00,1179,1,1660,184,481,183,88023
Action,093.jpg,data/CAT2000/trainSet/Stimuli/Action/093.jpg,ROI_01,861,295,1070,651,209,356,74404
Action,093.jpg,data/CAT2000/trainSet/Stimuli/Action/093.jpg,ROI_02,966,878,1099,985,133,107,14231
Action,095.jpg,data/CAT2000/trainSet/Stimuli/Action/095.jpg,ROI_00,871,414,1097,626,226,212,47912
Action,095.jpg,data/CAT2000/trainSet/Stimuli/Action/095.jpg,ROI_01,506,557,711,782,205,225,46125
Action,097.jpg,data/CAT2000/trainSet/Stimuli/Action/097.jpg,ROI_00,870,238,935,325,65,87,5655
Action,097.jpg,data/CAT2000/trainSet/Stimuli/Action/097.jpg,ROI_01,805,378,1230,757,425,379,161075
Action,099.jpg,data/CAT2000/trainSet/Stimuli/Action/099.jpg,ROI_00,807,171,1135,632,328,461,151208
Action,101.jpg,data/CAT2000/trainSet/Stimuli/Action/101.jpg,ROI_00,786,143,1126,688,340,545,185300
Action,101.jpg,data/CAT2000/trainSet/Stimuli/Action/101.jpg,ROI_01,1288,851,1489,1008,201,157,31557
Action,103.jpg,data/CAT2000/trainSet/Stimuli/Action/103.jpg,ROI_00,1252,320,1425,480,173,160,27680
Action,103.jpg,data/CAT2000/trainSet/Stimuli/Action/103.jpg,ROI_01,895,294,1238,598,343,304,104272
Action,103.jpg,data/CAT2000/trainSet/Stimuli/Action/103.jpg,ROI_02,1090,815,1199,976,109,161,17549
Action,105.jpg,data/CAT2000/trainSet/Stimuli/Action/105.jpg,ROI_00,831,389,1228,756,397,367,145699
Action,107.jpg,data/CAT2000/trainSet/Stimuli/Action/107.jpg,ROI_00,1372,296,1586,517,214,221,47294
Action,107.jpg,data/CAT2000/trainSet/Stimuli/Action/107.jpg,ROI_01,669,400,1140,712,471,312,146952
Action,109.jpg,data/CAT2000/trainSet/Stimuli/Action/109.jpg,ROI_00,883,220,1229,606,346,386,133556
Action,109.jpg,data/CAT2000/trainSet/Stimuli/Action/109.jpg,ROI_01,706,1027,763,1077,57,50,2850
Action,111.jpg,data/CAT2000/trainSet/Stimuli/Action/111.jpg,ROI_00,590,129,697,219,107,90,9630
Action,111.jpg,data/CAT2000/trainSet/Stimuli/Action/111.jpg,ROI_01,894,168,1092,369,198,201,39798
Action,111.jpg,data/CAT2000/trainSet/Stimuli/Action/111.jpg,ROI_02,694,416,1088,851,394,435,171390
Action,113.jpg,data/CAT2000/trainSet/Stimuli/Action/113.jpg,ROI_00,691,210,1076,631,385,421,162085
Action,113.jpg,data/CAT2000/trainSet/Stimuli/Action/113.jpg,ROI_01,713,661,857,809,144,148,21312
Action,115.jpg,data/CAT2000/trainSet/Stimuli/Action/115.jpg,ROI_00,849,281,1118,669,269,388,104372
Action,117.jpg,data/CAT2000/trainSet/Stimuli/Action/117.jpg,ROI_00,850,250,1127,824,277,574,158998
Action,117.jpg,data/CAT2000/trainSet/Stimuli/Action/117.jpg,ROI_01,760,916,893,1078,133,162,21546
Action,119.jpg,data/CAT2000/trainSet/Stimuli/Action/119.jpg,ROI_00,825,407,1162,682,337,275,92675
Action,119.jpg,data/CAT2000/trainSet/Stimuli/Action/119.jpg,ROI_01,1178,495,1442,654,264,159,41976
Action,121.jpg,data/CAT2000/trainSet/Stimuli/Action/121.jpg,ROI_00,355,284,525,452,170,168,28560
Action,121.jpg,data/CAT2000/trainSet/Stimuli/Action/121.jpg,ROI_01,1124,292,1563,482,439,190,83410
Action,121.jpg,data/CAT2000/trainSet/Stimuli/Action/121.jpg,ROI_02,706,299,1095,646,389,347,134983
Action,123.jpg,data/CAT2000/trainSet/Stimuli/Action/123.jpg,ROI_00,758,189,1174,641,416,452,188032
Action,125.jpg,data/CAT2000/trainSet/Stimuli/Action/125.jpg,ROI_00,792,248,1057,645,265,397,105205
Action,125.jpg,data/CAT2000/trainSet/Stimuli/Action/125.jpg,ROI_01,876,683,1062,896,186,213,39618
Action,127.jpg,data/CAT2000/trainSet/Stimuli/Action/127.jpg,ROI_00,598,172,837,476,239,304,72656
Action,127.jpg,data/CAT2000/trainSet/Stimuli/Action/127.jpg,ROI_01,868,112,1249,778,381,666,253746
Action,129.jpg,data/CAT2000/trainSet/Stimuli/Action/129.jpg,ROI_00,811,187,1123,690,312,503,156936
Action,131.jpg,data/CAT2000/trainSet/Stimuli/Action/131.jpg,ROI_00,306,352,445,450,139,98,13622
Action,131.jpg,data/CAT2000/trainSet/Stimuli/Action/131.jpg,ROI_01,786,144,1045,662,259,518,134162
Action,131.jpg,data/CAT2000/trainSet/Stimuli/Action/131.jpg,ROI_02,1111,320,1234,531,123,211,25953
Action,133.jpg,data/CAT2000/trainSet/Stimuli/Action/133.jpg,ROI_00,858,323,1076,679,218,356,77608
Action,133.jpg,data/CAT2000/trainSet/Stimuli/Action/133.jpg,ROI_01,501,454,739,589,238,135,32130
Action,133.jpg,data/CAT2000/trainSet/Stimuli/Action/133.jpg,ROI_02,1550,464,1634,597,84,133,11172
Action,135.jpg,data/CAT2000/trainSet/Stimuli/Action/135.jpg,ROI_00,816,386,1256,678,440,292,128480
Action,135.jpg,data/CAT2000/trainSet/Stimuli/Action/135.jpg,ROI_01,321,518,429,635,108,117,12636
Action,137.jpg,data/CAT2000/trainSet/Stimuli/Action/137.jpg,ROI_00,1566,341,1671,480,105,139,14595
Action,137.jpg,data/CAT2000/trainSet/Stimuli/Action/137.jpg,ROI_01,1321,361,1491,553,170,192,32640
Action,137.jpg,data/CAT2000/trainSet/Stimuli/Action/137.jpg,ROI_02,864,399,1218,713,354,314,111156
Action,137.jpg,data/CAT2000/trainSet/Stimuli/Action/137.jpg,ROI_03,511,600,613,700,102,100,10200
Action,139.jpg,data/CAT2000/trainSet/Stimuli/Action/139.jpg,ROI_00,1126,450,1339,649,213,199,42387
Action,139.jpg,data/CAT2000/trainSet/Stimuli/Action/139.jpg,ROI_01,665,441,1070,690,405,249,100845
Action,141.jpg,data/CAT2000/trainSet/Stimuli/Action/141.jpg,ROI_00,1258,256,1369,343,111,87,9657
Action,141.jpg,data/CAT2000/trainSet/Stimuli/Action/141.jpg,ROI_01,845,305,1167,627,322,322,103684
Action,141.jpg,data/CAT2000/trainSet/Stimuli/Action/141.jpg,ROI_02,1342,907,1543,1076,201,169,33969
Action,143.jpg,data/CAT2000/trainSet/Stimuli/Action/143.jpg,ROI_00,866,247,1197,739,331,492,162852
Action,145.jpg,data/CAT2000/trainSet/Stimuli/Action/145.jpg,ROI_00,1315,522,1452,652,137,130,17810
Action,145.jpg,data/CAT2000/trainSet/Stimuli/Action/145.jpg,ROI_01,894,442,1167,743,273,301,82173
Action,145.jpg,data/CAT2000/trainSet/Stimuli/Action/145.jpg,ROI_02,564,518,873,721,309,203,62727
Action,147.jpg,data/CAT2000/trainSet/Stimuli/Action/147.jpg,ROI_00,583,270,1210,731,627,461,289047
Action,149.jpg,data/CAT2000/trainSet/Stimuli/Action/149.jpg,ROI_00,597,95,696,192,99,97,9603
Action,149.jpg,data/CAT2000/trainSet/Stimuli/Action/149.jpg,ROI_01,885,122,1216,591,331,469,155239
Action,149.jpg,data/CAT2000/trainSet/Stimuli/Action/149.jpg,ROI_02,394,236,483,334,89,98,8722
Action,149.jpg,data/CAT2000/trainSet/Stimuli/Action/149.jpg,ROI_03,784,625,880,721,96,96,9216
Action,151.jpg,data/CAT2000/trainSet/Stimuli/Action/151.jpg,ROI_00,689,285,1154,859,465,574,266910
Action,153.jpg,data/CAT2000/trainSet/Stimuli/Action/153.jpg,ROI_00,1523,143,1694,355,171,212,36252
Action,153.jpg,data/CAT2000/trainSet/Stimuli/Action/153.jpg,ROI_01,780,257,1121,601,341,344,117304
Action,153.jpg,data/CAT2000/trainSet/Stimuli/Action/153.jpg,ROI_02,492,367,713,577,221,210,46410
Action,155.jpg,data/CAT2000/trainSet/Stimuli/Action/155.jpg,ROI_00,1518,140,1623,247,105,107,11235
Action,155.jpg,data/CAT2000/trainSet/Stimuli/Action/155.jpg,ROI_01,771,261,1070,624,299,363,108537
Action,155.jpg,data/CAT2000/trainSet/Stimuli/Action/155.jpg,ROI_02,1137,674,1271,828,134,154,20636
Action,155.jpg,data/CAT2000/trainSet/Stimuli/Action/155.jpg,ROI_03,448,739,554,821,106,82,8692
Action,157.jpg,data/CAT2000/trainSet/Stimuli/Action/157.jpg,ROI_00,408,360,657,538,249,178,44322
Action,157.jpg,data/CAT2000/trainSet/Stimuli/Action/157.jpg,ROI_01,1427,421,1548,559,121,138,16698
Action,157.jpg,data/CAT2000/trainSet/Stimuli/Action/157.jpg,ROI_02,770,360,1244,635,474,275,130350
Action,159.jpg,data/CAT2000/trainSet/Stimuli/Action/159.jpg,ROI_00,1209,225,1376,413,167,188,31396
Action,159.jpg,data/CAT2000/trainSet/Stimuli/Action/159.jpg,ROI_01,772,148,1194,626,422,478,201716
Action,161.jpg,data/CAT2000/trainSet/Stimuli/Action/161.jpg,ROI_00,1199,135,1561,394,362,259,93758
Action,161.jpg,data/CAT2000/trainSet/Stimuli/Action/161.jpg,ROI_01,1233,396,1322,507,89,111,9879
Action,161.jpg,data/CAT2000/trainSet/Stimuli/Action/161.jpg,ROI_02,871,439,1087,645,216,206,44496
Action,161.jpg,data/CAT2000/trainSet/Stimuli/Action/161.jpg,ROI_03,708,823,857,996,149,173,25777
Action,163.jpg,data/CAT2000/trainSet/Stimuli/Action/163.jpg,ROI_00,661,250,1042,638,381,388,147828
Action,163.jpg,data/CAT2000/trainSet/Stimuli/Action/163.jpg,ROI_01,951,759,1113,947,162,188,30456
Action,165.jpg,data/CAT2000/trainSet/Stimuli/Action/165.jpg,ROI_00,828,241,1158,660,330,419,138270
Action,165.jpg,data/CAT2000/trainSet/Stimuli/Action/165.jpg,ROI_01,998,789,1157,916,159,127,20193
Action,167.jpg,data/CAT2000/trainSet/Stimuli/Action/167.jpg,ROI_00,858,310,1109,773,251,463,116213
Action,169.jpg,data/CAT2000/trainSet/Stimuli/Action/169.jpg,ROI_00,773,146,1055,596,282,450,126900
Action,169.jpg,data/CAT2000/trainSet/Stimuli/Action/169.jpg,ROI_01,910,881,1052,1000,142,119,16898
Action,171.jpg,data/CAT2000/trainSet/Stimuli/Action/171.jpg,ROI_00,833,218,1182,671,349,453,158097
Action,173.jpg,data/CAT2000/trainSet/Stimuli/Action/173.jpg,ROI_00,819,210,956,361,137,151,20687
Action,173.jpg,data/CAT2000/trainSet/Stimuli/Action/173.jpg,ROI_01,1111,292,1451,563,340,271,92140
Action,173.jpg,data/CAT2000/trainSet/Stimuli/Action/173.jpg,ROI_02,914,449,1062,644,148,195,28860
Action,175.jpg,data/CAT2000/trainSet/Stimuli/Action/175.jpg,ROI_00,1077,17,1242,219,165,202,33330
Action,175.jpg,data/CAT2000/trainSet/Stimuli/Action/175.jpg,ROI_01,474,301,709,525,235,224,52640
Action,175.jpg,data/CAT2000/trainSet/Stimuli/Action/175.jpg,ROI_02,1257,362,1355,474,98,112,10976
Action,175.jpg,data/CAT2000/trainSet/Stimuli/Action/175.jpg,ROI_03,812,282,1069,633,257,351,90207
Action,177.jpg,data/CAT2000/trainSet/Stimuli/Action/177.jpg,ROI_00,592,324,1077,657,485,333,161505
Action,179.jpg,data/CAT2000/trainSet/Stimuli/Action/179.jpg,ROI_00,707,158,1070,641,363,483,175329
Action,179.jpg,data/CAT2000/trainSet/Stimuli/Action/179.jpg,ROI_01,1190,443,1325,549,135,106,14310
Action,181.jpg,data/CAT2000/trainSet/Stimuli/Action/181.jpg,ROI_00,925,207,1119,415,194,208,40352
Action,181.jpg,data/CAT2000/trainSet/Stimuli/Action/181.jpg,ROI_01,883,419,991,473,108,54,5832
Action,181.jpg,data/CAT2000/trainSet/Stimuli/Action/181.jpg,ROI_02,1138,337,1380,564,242,227,54934
Action,181.jpg,data/CAT2000/trainSet/Stimuli/Action/181.jpg,ROI_03,912,492,1038,642,126,150,18900
Action,181.jpg,data/CAT2000/trainSet/Stimuli/Action/181.jpg,ROI_04,1078,728,1189,859,111,131,14541
Action,183.jpg,data/CAT2000/trainSet/Stimuli/Action/183.jpg,ROI_00,774,73,1095,695,321,622,199662
Action,183.jpg,data/CAT2000/trainSet/Stimuli/Action/183.jpg,ROI_01,784,984,915,1040,131,56,7336
Action,185.jpg,data/CAT2000/trainSet/Stimuli/Action/185.jpg,ROI_00,838,133,1137,766,299,633,189267
Action,185.jpg,data/CAT2000/trainSet/Stimuli/Action/185.jpg,ROI_01,1023,813,1145,897,122,84,10248
Action,187.jpg,data/CAT2000/trainSet/Stimuli/Action/187.jpg,ROI_00,860,137,1099,830,239,693,165627
Action,189.jpg,data/CAT2000/trainSet/Stimuli/Action/189.jpg,ROI_00,1415,313,1622,515,207,202,41814
Action,189.jpg,data/CAT2000/trainSet/Stimuli/Action/189.jpg,ROI_01,515,309,1061,633,546,324,176904
Action,189.jpg,data/CAT2000/trainSet/Stimuli/Action/189.jpg,ROI_02,773,967,840,1016,67,49,3283
Action,191.jpg,data/CAT2000/trainSet/Stimuli/Action/191.jpg,ROI_00,840,97,1059,636,219,539,118041
Action,191.jpg,data/CAT2000/trainSet/Stimuli/Action/191.jpg,ROI_01,1082,578,1221,704,139,126,17514
Action,191.jpg,data/CAT2000/trainSet/Stimuli/Action/191.jpg,ROI_02,906,809,1014,900,108,91,9828
Action,193.jpg,data/CAT2000/trainSet/Stimuli/Action/193.jpg,ROI_00,1494,147,1676,320,182,173,31486
Action,193.jpg,data/CAT2000/trainSet/Stimuli/Action/193.jpg,ROI_01,823,170,1049,623,226,453,102378
Action,193.jpg,data/CAT2000/trainSet/Stimuli/Action/193.jpg,ROI_02,409,536,606,710,197,174,34278
Action,195.jpg,data/CAT2000/trainSet/Stimuli/Action/195.jpg,ROI_00,1498,368,1659,539,161,171,27531
Action,195.jpg,data/CAT2000/trainSet/Stimuli/Action/195.jpg,ROI_01,741,386,1095,657,354,271,95934
Action,195.jpg,data/CAT2000/trainSet/Stimuli/Action/195.jpg,ROI_02,1173,510,1300,618,127,108,13716
Action,195.jpg,data/CAT2000/trainSet/Stimuli/Action/195.jpg,ROI_03,1448,591,1595,734,147,143,21021
Action,197.jpg,data/CAT2000/trainSet/Stimuli/Action/197.jpg,ROI_00,1508,106,1673,257,165,151,24915
Action,197.jpg,data/CAT2000/trainSet/Stimuli/Action/197.jpg,ROI_01,775,246,1059,620,284,374,106216
Action,197.jpg,data/CAT2000/trainSet/Stimuli/Action/197.jpg,ROI_02,577,393,693,522,116,129,14964
Action,199.jpg,data/CAT2000/trainSet/Stimuli/Action/199.jpg,ROI_00,729,386,1092,677,363,291,105633
Affective,001.jpg,data/CAT2000/trainSet/Stimuli/Affective/001.jpg,ROI_00,1239,371,1350,548,111,177,19647
Affective,001.jpg,data/CAT2000/trainSet/Stimuli/Affective/001.jpg,ROI_01,878,382,1098,669,220,287,63140
Affective,003.jpg,data/CAT2000/trainSet/Stimuli/Affective/003.jpg,ROI_00,1106,286,1616,587,510,301,153510
Affective,003.jpg,data/CAT2000/trainSet/Stimuli/Affective/003.jpg,ROI_01,915,470,1083,644,168,174,29232
Affective,005.jpg,data/CAT2000/trainSet/Stimuli/Affective/005.jpg,ROI_00,910,280,1352,661,442,381,168402
Affective,007.jpg,data/CAT2000/trainSet/Stimuli/Affective/007.jpg,ROI_00,756,281,1190,705,434,424,184016
Affective,007.jpg,data/CAT2000/trainSet/Stimuli/Affective/007.jpg,ROI_01,1095,709,1177,818,82,109,8938
Affective,009.jpg,data/CAT2000/trainSet/Stimuli/Affective/009.jpg,ROI_00,1231,299,1418,483,187,184,34408
Affective,009.jpg,data/CAT2000/trainSet/Stimuli/Affective/009.jpg,ROI_01,865,346,1110,681,245,335,82075
Affective,009.jpg,data/CAT2000/trainSet/Stimuli/Affective/009.jpg,ROI_02,1293,671,1469,839,176,168,29568
Affective,011.jpg,data/CAT2000/trainSet/Stimuli/Affective/011.jpg,ROI_00,757,289,1093,709,336,420,141120
Affective,013.jpg,data/CAT2000/trainSet/Stimuli/Affective/013.jpg,ROI_00,778,186,1160,765,382,579,221178
Affective,015.jpg,data/CAT2000/trainSet/Stimuli/Affective/015.jpg,ROI_00,494,205,671,461,177,256,45312
Affective,015.jpg,data/CAT2000/trainSet/Stimuli/Affective/015.jpg,ROI_01,875,440,1032,577,157,137,21509
Affective,015.jpg,data/CAT2000/trainSet/Stimuli/Affective/015.jpg,ROI_02,1318,547,1544,808,226,261,58986
Affective,017.jpg,data/CAT2000/trainSet/Stimuli/Affective/017.jpg,ROI_00,1530,263,1730,428,200,165,33000
Affective,017.jpg,data/CAT2000/trainSet/Stimuli/Affective/017.jpg,ROI_01,746,190,1107,617,361,427,154147
Affective,017.jpg,data/CAT2000/trainSet/Stimuli/Affective/017.jpg,ROI_02,425,439,660,630,235,191,44885
Affective,019.jpg,data/CAT2000/trainSet/Stimuli/Affective/019.jpg,ROI_00,1436,335,1572,438,136,103,14008
Affective,019.jpg,data/CAT2000/trainSet/Stimuli/Affective/019.jpg,ROI_01,841,212,1121,657,280,445,124600
Affective,021.jpg,data/CAT2000/trainSet/Stimuli/Affective/021.jpg,ROI_00,751,360,1123,758,372,398,148056
Affective,021.jpg,data/CAT2000/trainSet/Stimuli/Affective/021.jpg,ROI_01,931,755,1037,871,106,116,12296
Affective,023.jpg,data/CAT2000/trainSet/Stimuli/Affective/023.jpg,ROI_00,845,38,1218,815,373,777,289821
Affective,025.jpg,data/CAT2000/trainSet/Stimuli/Affective/025.jpg,ROI_00,235,249,425,446,190,197,37430
Affective,025.jpg,data/CAT2000/trainSet/Stimuli/Affective/025.jpg,ROI_01,839,396,1182,881,343,485,166355
Affective,027.jpg,data/CAT2000/trainSet/Stimuli/Affective/027.jpg,ROI_00,753,109,899,270,146,161,23506
Affective,027.jpg,data/CAT2000/trainSet/Stimuli/Affective/027.jpg,ROI_01,474,178,673,348,199,170,33830
Affective,027.jpg,data/CAT2000/trainSet/Stimuli/Affective/027.jpg,ROI_02,800,382,1051,791,251,409,102659
Affective,029.jpg,data/CAT2000/trainSet/Stimuli/Affective/029.jpg,ROI_00,276,214,600,516,324,302,97848
Affective,029.jpg,data/CAT2000/trainSet/Stimuli/Affective/029.jpg,ROI_01,851,385,1277,680,426,295,125670
Affective,031.jpg,data/CAT2000/trainSet/Stimuli/Affective/031.jpg,ROI_00,864,189,1259,644,395,455,179725
Affective,033.jpg,data/CAT2000/trainSet/Stimuli/Affective/033.jpg,ROI_00,622,171,1253,842,631,671,423401
Affective,035.jpg,data/CAT2000/trainSet/Stimuli/Affective/035.jpg,ROI_00,827,227,1119,711,292,484,141328
Affective,037.jpg,data/CAT2000/trainSet/Stimuli/Affective/037.jpg,ROI_00,857,173,1096,637,239,464,110896
Affective,037.jpg,data/CAT2000/trainSet/Stimuli/Affective/037.jpg,ROI_01,1185,972,1316,1079,131,107,14017
Affective,039.jpg,data/CAT2000/trainSet/Stimuli/Affective/039.jpg,ROI_00,861,233,1226,813,365,580,211700
Affective,041.jpg,data/CAT2000/trainSet/Stimuli/Affective/041.jpg,ROI_00,792,224,1080,617,288,393,113184
Affective,041.jpg,data/CAT2000/trainSet/Stimuli/Affective/041.jpg,ROI_01,799,631,916,742,117,111,12987
Affective,043.jpg,data/CAT2000/trainSet/Stimuli/Affective/043.jpg,ROI_00,836,140,1091,598,255,458,116790
Affective,043.jpg,data/CAT2000/trainSet/Stimuli/Affective/043.jpg,ROI_01,1479,191,1599,355,120,164,19680
Affective,045.jpg,data/CAT2000/trainSet/Stimuli/Affective/045.jpg,ROI_00,519,43,834,303,315,260,81900
Affective,045.jpg,data/CAT2000/trainSet/Stimuli/Affective/045.jpg,ROI_01,412,431,634,629,222,198,43956
Affective,045.jpg,data/CAT2000/trainSet/Stimuli/Affective/045.jpg,ROI_02,883,423,1058,690,175,267,46725
Affective,047.jpg,data/CAT2000/trainSet/Stimuli/Affective/047.jpg,ROI_00,864,222,1153,701,289,479,138431
Affective,049.jpg,data/CAT2000/trainSet/Stimuli/Affective/049.jpg,ROI_00,851,170,1209,641,358,471,168618
Affective,049.jpg,data/CAT2000/trainSet/Stimuli/Affective/049.jpg,ROI_01,515,437,700,584,185,147,27195
Affective,049.jpg,data/CAT2000/trainSet/Stimuli/Affective/049.jpg,ROI_02,1377,525,1591,657,214,132,28248
Affective,049.jpg,data/CAT2000/trainSet/Stimuli/Affective/049.jpg,ROI_03,1032,653,1107,762,75,109,8175
Affective,051.jpg,data/CAT2000/trainSet/Stimuli/Affective/051.jpg,ROI_00,1232,190,1471,485,239,295,70505
Affective,051.jpg,data/CAT2000/trainSet/Stimuli/Affective/051.jpg,ROI_01,374,344,514,464,140,120,16800
Affective,051.jpg,data/CAT2000/trainSet/Stimuli/Affective/051.jpg,ROI_02,890,395,1107,639,217,244,52948
Affective,053.jpg,data/CAT2000/trainSet/Stimuli/Affective/053.jpg,ROI_00,510,272,633,480,123,208,25584
Affective,053.jpg,data/CAT2000/trainSet/Stimuli/Affective/053.jpg,ROI_01,817,188,1081,639,264,451,119064
Affective,053.jpg,data/CAT2000/trainSet/Stimuli/Affective/053.jpg,ROI_02,1405,352,1585,583,180,231,41580
Affective,055.jpg,data/CAT2000/trainSet/Stimuli/Affective/055.jpg,ROI_00,1183,201,1351,350,168,149,25032
Affective,055.jpg,data/CAT2000/trainSet/Stimuli/Affective/055.jpg,ROI_01,790,215,1149,644,359,429,154011
Affective,057.jpg,data/CAT2000/trainSet/Stimuli/Affective/057.jpg,ROI_00,808,134,1113,678,305,544,165920
Affective,057.jpg,data/CAT2000/trainSet/Stimuli/Affective/057.jpg,ROI_01,901,679,994,762,93,83,7719
Affective,059.jpg,data/CAT2000/trainSet/Stimuli/Affective/059.jpg,ROI_00,853,72,1170,715,317,643,203831
Affective,061.jpg,data/CAT2000/trainSet/Stimuli/Affective/061.jpg,ROI_00,845,204,1164,601,319,397,126643
Affective,061.jpg,data/CAT2000/trainSet/Stimuli/Affective/061.jpg,ROI_01,486,724,744,917,258,193,49794
Affective,063.jpg,data/CAT2000/trainSet/Stimuli/Affective/063.jpg,ROI_00,780,226,1136,648,356,422,150232
Affective,065.jpg,data/CAT2000/trainSet/Stimuli/Affective/065.jpg,ROI_00,816,283,1168,707,352,424,149248
Affective,065.jpg,data/CAT2000/trainSet/Stimuli/Affective/065.jpg,ROI_01,718,926,849,1060,131,134,17554
Affective,067.jpg,data/CAT2000/trainSet/Stimuli/Affective/067.jpg,ROI_00,788,411,1117,741,329,330,108570
Affective,069.jpg,data/CAT2000/trainSet/Stimuli/Affective/069.jpg,ROI_00,721,403,1126,887,405,484,196020
Affective,071.jpg,data/CAT2000/trainSet/Stimuli/Affective/071.jpg,ROI_00,684,365,1129,739,445,374,166430
Affective,071.jpg,data/CAT2000/trainSet/Stimuli/Affective/071.jpg,ROI_01,1214,544,1316,644,102,100,10200
Affective,073.jpg,data/CAT2000/trainSet/Stimuli/Affective/073.jpg,ROI_00,601,247,1087,664,486,417,202662
Affective,075.jpg,data/CAT2000/trainSet/Stimuli/Affective/075.jpg,ROI_00,856,429,1153,650,297,221,65637
Affective,075.jpg,data/CAT2000/trainSet/Stimuli/Affective/075.jpg,ROI_01,1190,441,1483,651,293,210,61530
Affective,075.jpg,data/CAT2000/trainSet/Stimuli/Affective/075.jpg,ROI_02,468,443,683,655,215,212,45580
Affective,077.jpg,data/CAT2000/trainSet/Stimuli/Affective/077.jpg,ROI_00,1078,88,1292,351,214,263,56282
Affective,077.jpg,data/CAT2000/trainSet/Stimuli/Affective/077.jpg,ROI_01,873,459,1033,639,160,180,28800
Affective,077.jpg,data/CAT2000/trainSet/Stimuli/Affective/077.jpg,ROI_02,1467,690,1605,799,138,109,15042
Affective,077.jpg,data/CAT2000/trainSet/Stimuli/Affective/077.jpg,ROI_03,411,676,693,926,282,250,70500
Affective,079.jpg,data/CAT2000/trainSet/Stimuli/Affective/079.jpg,ROI_00,1253,104,1407,319,154,215,33110
Affective,079.jpg,data/CAT2000/trainSet/Stimuli/Affective/079.jpg,ROI_01,800,407,1203,812,403,405,163215
Affective,081.jpg,data/CAT2000/trainSet/Stimuli/Affective/081.jpg,ROI_00,901,120,1102,340,201,220,44220
Affective,081.jpg,data/CAT2000/trainSet/Stimuli/Affective/081.jpg,ROI_01,874,410,1151,728,277,318,88086
Affective,083.jpg,data/CAT2000/trainSet/Stimuli/Affective/083.jpg,ROI_00,583,257,1057,624,474,367,173958
Affective,085.jpg,data/CAT2000/trainSet/Stimuli/Affective/085.jpg,ROI_00,795,328,1156,625,361,297,107217
Affective,087.jpg,data/CAT2000/trainSet/Stimuli/Affective/087.jpg,ROI_00,710,129,964,422,254,293,74422
Affective,087.jpg,data/CAT2000/trainSet/Stimuli/Affective/087.jpg,ROI_01,1134,202,1320,372,186,170,31620
Affective,087.jpg,data/CAT2000/trainSet/Stimuli/Affective/087.jpg,ROI_02,864,455,1071,637,207,182,37674
Affective,087.jpg,data/CAT2000/trainSet/Stimuli/Affective/087.jpg,ROI_03,343,909,532,1073,189,164,30996
Affective,089.jpg,data/CAT2000/trainSet/Stimuli/Affective/089.jpg,ROI_00,497,167,838,471,341,304,103664
Affective,089.jpg,data/CAT2000/trainSet/Stimuli/Affective/089.jpg,ROI_01,1476,277,1571,398,95,121,11495
Affective,089.jpg,data/CAT2000/trainSet/Stimuli/Affective/089.jpg,ROI_02,844,303,1188,812,344,509,175096
Affective,091.jpg,data/CAT2000/trainSet/Stimuli/Affective/091.jpg,ROI_00,825,327,1232,813,407,486,197802
Affective,093.jpg,data/CAT2000/trainSet/Stimuli/Affective/093.jpg,ROI_00,717,347,1132,663,415,316,131140
Affective,095.jpg,data/CAT2000/trainSet/Stimuli/Affective/095.jpg,ROI_00,758,285,1152,680,394,395,155630
Affective,097.jpg,data/CAT2000/trainSet/Stimuli/Affective/097.jpg,ROI_00,777,184,1116,1024,339,840,284760
Affective,099.jpg,data/CAT2000/trainSet/Stimuli/Affective/099.jpg,ROI_00,885,59,1135,300,250,241,60250
Affective,099.jpg,data/CAT2000/trainSet/Stimuli/Affective/099.jpg,ROI_01,262,217,433,362,171,145,24795
Affective,099.jpg,data/CAT2000/trainSet/Stimuli/Affective/099.jpg,ROI_02,1697,285,1874,450,177,165,29205
Affective,099.jpg,data/CAT2000/trainSet/Stimuli/Affective/099.jpg,ROI_03,842,417,1059,648,217,231,50127
Affective,099.jpg,data/CAT2000/trainSet/Stimuli/Affective/099.jpg,ROI_04,1647,812,1804,1025,157,213,33441
Affective,101.jpg,data/CAT2000/trainSet/Stimuli/Affective/101.jpg,ROI_00,869,341,1183,815,314,474,148836
Affective,103.jpg,data/CAT2000/trainSet/Stimuli/Affective/103.jpg,ROI_00,655,435,1152,798,497,363,180411
Affective,105.jpg,data/CAT2000/trainSet/Stimuli/Affective/105.jpg,ROI_00,767,317,1114,793,347,476,165172
Affective,107.jpg,data/CAT2000/trainSet/Stimuli/Affective/107.jpg,ROI_00,914,62,1146,345,232,283,65656
Affective,107.jpg,data/CAT2000/trainSet/Stimuli/Affective/107.jpg,ROI_01,827,356,1074,646,247,290,71630
Affective,107.jpg,data/CAT2000/trainSet/Stimuli/Affective/107.jpg,ROI_02,725,661,846,767,121,106,12826
Affective,107.jpg,data/CAT2000/trainSet/Stimuli/Affective/107.jpg,ROI_03,1518,856,1675,1072,157,216,33912
Affective,109.jpg,data/CAT2000/trainSet/Stimuli/Affective/109.jpg,ROI_00,660,315,1205,651,545,336,183120
Affective,109.jpg,data/CAT2000/trainSet/Stimuli/Affective/109.jpg,ROI_01,748,661,893,814,145,153,22185
Affective,109.jpg,data/CAT2000/trainSet/Stimuli/Affective/109.jpg,ROI_02,700,1039,761,1080,61,41,2501
Affective,111.jpg,data/CAT2000/trainSet/Stimuli/Affective/111.jpg,ROI_00,714,203,1098,648,384,445,170880
Affective,113.jpg,data/CAT2000/trainSet/Stimuli/Affective/113.jpg,ROI_00,1178,444,1311,625,133,181,24073
Affective,113.jpg,data/CAT2000/trainSet/Stimuli/Affective/113.jpg,ROI_01,765,335,1167,816,402,481,193362
Affective,115.jpg,data/CAT2000/trainSet/Stimuli/Affective/115.jpg,ROI_00,776,237,1294,715,518,478,247604
Affective,117.jpg,data/CAT2000/trainSet/Stimuli/Affective/117.jpg,ROI_00,760,200,1075,670,315,470,148050
Affective,119.jpg,data/CAT2000/trainSet/Stimuli/Affective/119.jpg,ROI_00,774,376,1120,774,346,398,137708
Affective,121.jpg,data/CAT2000/trainSet/Stimuli/Affective/121.jpg,ROI_00,474,204,721,428,247,224,55328
Affective,121.jpg,data/CAT2000/trainSet/Stimuli/Affective/121.jpg,ROI_01,1186,226,1387,433,201,207,41607
Affective,121.jpg,data/CAT2000/trainSet/Stimuli/Affective/121.jpg,ROI_02,729,277,1054,621,325,344,111800
Affective,123.jpg,data/CAT2000/trainSet/Stimuli/Affective/123.jpg,ROI_00,300,243,823,861,523,618,323214
Affective,123.jpg,data/CAT2000/trainSet/Stimuli/Affective/123.jpg,ROI_01,865,423,1072,627,207,204,42228
Affective,125.jpg,data/CAT2000/trainSet/Stimuli/Affective/125.jpg,ROI_00,1129,314,1230,425,101,111,11211
Affective,125.jpg,data/CAT2000/trainSet/Stimuli/Affective/125.jpg,ROI_01,1114,426,1234,512,120,86,10320
Affective,125.jpg,data/CAT2000/trainSet/Stimuli/Affective/125.jpg,ROI_02,580,343,1053,668,473,325,153725
Affective,127.jpg,data/CAT2000/trainSet/Stimuli/Affective/127.jpg,ROI_00,586,392,1180,954,594,562,333828
Affective,127.jpg,data/CAT2000/trainSet/Stimuli/Affective/127.jpg,ROI_01,1246,748,1443,963,197,215,42355
Affective,129.jpg,data/CAT2000/trainSet/Stimuli/Affective/129.jpg,ROI_00,812,318,1208,800,396,482,190872
Affective,131.jpg,data/CAT2000/trainSet/Stimuli/Affective/131.jpg,ROI_00,683,301,1235,678,552,377,208104
Affective,131.jpg,data/CAT2000/trainSet/Stimuli/Affective/131.jpg,ROI_01,857,776,1024,955,167,179,29893
Affective,133.jpg,data/CAT2000/trainSet/Stimuli/Affective/133.jpg,ROI_00,707,331,1233,742,526,411,216186
Affective,135.jpg,data/CAT2000/trainSet/Stimuli/Affective/135.jpg,ROI_00,485,422,604,521,119,99,11781
Affective,135.jpg,data/CAT2000/trainSet/Stimuli/Affective/135.jpg,ROI_01,698,317,1170,798,472,481,227032
Affective,137.jpg,data/CAT2000/trainSet/Stimuli/Affective/137.jpg,ROI_00,434,293,551,453,117,160,18720
Affective,137.jpg,data/CAT2000/trainSet/Stimuli/Affective/137.jpg,ROI_01,755,415,1235,678,480,263,126240
Affective,137.jpg,data/CAT2000/trainSet/Stimuli/Affective/137.jpg,ROI_02,1350,814,1485,939,135,125,16875
Affective,139.jpg,data/CAT2000/trainSet/Stimuli/Affective/139.jpg,ROI_00,841,334,1205,821,364,487,177268
Affective,139.jpg,data/CAT2000/trainSet/Stimuli/Affective/139.jpg,ROI_01,1017,830,1113,918,96,88,8448
Affective,141.jpg,data/CAT2000/trainSet/Stimuli/Affective/141.jpg,ROI_00,632,168,819,384,187,216,40392
Affective,141.jpg,data/CAT2000/trainSet/Stimuli/Affective/141.jpg,ROI_01,885,473,1056,686,171,213,36423
Affective,141.jpg,data/CAT2000/trainSet/Stimuli/Affective/141.jpg,ROI_02,1272,589,1449,744,177,155,27435
Affective,141.jpg,data/CAT2000/trainSet/Stimuli/Affective/141.jpg,ROI_03,872,691,1124,873,252,182,45864
Affective,143.jpg,data/CAT2000/trainSet/Stimuli/Affective/143.jpg,ROI_00,855,468,1137,658,282,190,53580
Affective,143.jpg,data/CAT2000/trainSet/Stimuli/Affective/143.jpg,ROI_01,1233,460,1720,666,487,206,100322
Affective,145.jpg,data/CAT2000/trainSet/Stimuli/Affective/145.jpg,ROI_00,865,128,1183,773,318,645,205110
Affective,147.jpg,data/CAT2000/trainSet/Stimuli/Affective/147.jpg,ROI_00,1191,80,1429,378,238,298,70924
Affective,147.jpg,data/CAT2000/trainSet/Stimuli/Affective/147.jpg,ROI_01,615,204,807,398,192,194,37248
Affective,147.jpg,data/CAT2000/trainSet/Stimuli/Affective/147.jpg,ROI_02,834,384,1036,660,202,276,55752
Affective,149.jpg,data/CAT2000/trainSet/Stimuli/Affective/149.jpg,ROI_00,810,169,1099,714,289,545,157505
Affective,151.jpg,data/CAT2000/trainSet/Stimuli/Affective/151.jpg,ROI_00,1240,136,1482,333,242,197,47674
Affective,151.jpg,data/CAT2000/trainSet/Stimuli/Affective/151.jpg,ROI_01,808,419,1283,835,475,416,197600
Affective,153.jpg,data/CAT2000/trainSet/Stimuli/Affective/153.jpg,ROI_00,451,270,532,366,81,96,7776
Affective,153.jpg,data/CAT2000/trainSet/Stimuli/Affective/153.jpg,ROI_01,767,234,1081,616,314,382,119948
Affective,153.jpg,data/CAT2000/trainSet/Stimuli/Affective/153.jpg,ROI_02,1098,272,1330,520,232,248,57536
Affective,155.jpg,data/CAT2000/trainSet/Stimuli/Affective/155.jpg,ROI_00,755,70,977,319,222,249,55278
Affective,155.jpg,data/CAT2000/trainSet/Stimuli/Affective/155.jpg,ROI_01,897,237,1319,611,422,374,157828
Affective,157.jpg,data/CAT2000/trainSet/Stimuli/Affective/157.jpg,ROI_00,836,149,1186,748,350,599,209650
Affective,159.jpg,data/CAT2000/trainSet/Stimuli/Affective/159.jpg,ROI_00,853,400,1444,719,591,319,188529
Affective,161.jpg,data/CAT2000/trainSet/Stimuli/Affective/161.jpg,ROI_00,855,222,1149,652,294,430,126420
Affective,161.jpg,data/CAT2000/trainSet/Stimuli/Affective/161.jpg,ROI_01,1368,539,1471,630,103,91,9373
Affective,161.jpg,data/CAT2000/trainSet/Stimuli/Affective/161.jpg,ROI_02,598,781,742,929,144,148,21312
Affective,163.jpg,data/CAT2000/trainSet/Stimuli/Affective/163.jpg,ROI_00,681,258,1114,727,433,469,203077
Affective,165.jpg,data/CAT2000/trainSet/Stimuli/Affective/165.jpg,ROI_00,829,449,1139,693,310,244,75640
Affective,165.jpg,data/CAT2000/trainSet/Stimuli/Affective/165.jpg,ROI_01,1175,507,1345,694,170,187,31790
Affective,165.jpg,data/CAT2000/trainSet/Stimuli/Affective/165.jpg,ROI_02,681,721,799,826,118,105,12390
Affective,167.jpg,data/CAT2000/trainSet/Stimuli/Affective/167.jpg,ROI_00,689,431,1073,682,384,251,96384
Affective,167.jpg,data/CAT2000/trainSet/Stimuli/Affective/167.jpg,ROI_01,332,620,624,831,292,211,61612
Affective,169.jpg,data/CAT2000/trainSet/Stimuli/Affective/169.jpg,ROI_00,791,110,904,247,113,137,15481
Affective,169.jpg,data/CAT2000/trainSet/Stimuli/Affective/169.jpg,ROI_01,612,330,1043,678,431,348,149988
Affective,171.jpg,data/CAT2000/trainSet/Stimuli/Affective/171.jpg,ROI_00,427,67,572,241,145,174,25230
Affective,171.jpg,data/CAT2000/trainSet/Stimuli/Affective/171.jpg,ROI_01,820,153,1082,640,262,487,127594
Affective,173.jpg,data/CAT2000/trainSet/Stimuli/Affective/173.jpg,ROI_00,821,288,1156,691,335,403,135005
Affective,175.jpg,data/CAT2000/trainSet/Stimuli/Affective/175.jpg,ROI_00,663,246,1337,671,674,425,286450
Affective,177.jpg,data/CAT2000/trainSet/Stimuli/Affective/177.jpg,ROI_00,728,293,1262,732,534,439,234426
Affective,179.jpg,data/CAT2000/trainSet/Stimuli/Affective/179.jpg,ROI_00,855,251,1167,670,312,419,130728
Affective,181.jpg,data/CAT2000/trainSet/Stimuli/Affective/181.jpg,ROI_00,360,129,630,362,270,233,62910
Affective,181.jpg,data/CAT2000/trainSet/Stimuli/Affective/181.jpg,ROI_01,1145,199,1328,408,183,209,38247
Affective,181.jpg,data/CAT2000/trainSet/Stimuli/Affective/181.jpg,ROI_02,896,437,1064,617,168,180,30240
Affective,183.jpg,data/CAT2000/trainSet/Stimuli/Affective/183.jpg,ROI_00,1201,274,1350,412,149,138,20562
Affective,183.jpg,data/CAT2000/trainSet/Stimuli/Affective/183.jpg,ROI_01,885,406,1075,634,190,228,43320
Affective,183.jpg,data/CAT2000/trainSet/Stimuli/Affective/183.jpg,ROI_02,464,414,637,662,173,248,42904
Affective,183.jpg,data/CAT2000/trainSet/Stimuli/Affective/183.jpg,ROI_03,777,942,817,1006,40,64,2560
Affective,185.jpg,data/CAT2000/trainSet/Stimuli/Affective/185.jpg,ROI_00,506,195,676,397,170,202,34340
Affective,185.jpg,data/CAT2000/trainSet/Stimuli/Affective/185.jpg,ROI_01,859,226,1108,638,249,412,102588
Affective,187.jpg,data/CAT2000/trainSet/Stimuli/Affective/187.jpg,ROI_00,743,260,902,413,159,153,24327
Affective,187.jpg,data/CAT2000/trainSet/Stimuli/Affective/187.jpg,ROI_01,839,425,1036,620,197,195,38415
Affective,187.jpg,data/CAT2000/trainSet/Stimuli/Affective/187.jpg,ROI_02,144,700,241,771,97,71,6887
Affective,187.jpg,data/CAT2000/trainSet/Stimuli/Affective/187.jpg,ROI_03,720,948,826,1056,106,108,11448
Affective,189.jpg,data/CAT2000/trainSet/Stimuli/Affective/189.jpg,ROI_00,891,228,1273,620,382,392,149744
Affective,189.jpg,data/CAT2000/trainSet/Stimuli/Affective/189.jpg,ROI_01,756,1001,813,1071,57,70,3990
Affective,191.jpg,data/CAT2000/trainSet/Stimuli/Affective/191.jpg,ROI_00,697,371,1088,809,391,438,171258
Affective,193.jpg,data/CAT2000/trainSet/Stimuli/Affective/193.jpg,ROI_00,1147,54,1341,163,194,109,21146
Affective,193.jpg,data/CAT2000/trainSet/Stimuli/Affective/193.jpg,ROI_01,836,410,1143,828,307,418,128326
Affective,193.jpg,data/CAT2000/trainSet/Stimuli/Affective/193.jpg,ROI_02,651,877,747,962,96,85,8160
Affective,195.jpg,data/CAT2000/trainSet/Stimuli/Affective/195.jpg,ROI_00,729,313,1128,645,399,332,132468
Affective,195.jpg,data/CAT2000/trainSet/Stimuli/Affective/195.jpg,ROI_01,1079,648,1349,925,270,277,74790
Affective,197.jpg,data/CAT2000/trainSet/Stimuli/Affective/197.jpg,ROI_00,865,417,1295,777,430,360,154800
Affective,199.jpg,data/CAT2000/trainSet/Stimuli/Affective/199.jpg,ROI_00,960,48,1328,379,368,331,121808
Affective,199.jpg,data/CAT2000/trainSet/Stimuli/Affective/199.jpg,ROI_01,837,381,1110,631,273,250,68250
Indoor,001.jpg,data/CAT2000/trainSet/Stimuli/Indoor/001.jpg,ROI_00,762,178,1124,674,362,496,179552
Indoor,003.jpg,data/CAT2000/trainSet/Stimuli/Indoor/003.jpg,ROI_00,1533,231,1788,419,255,188,47940
Indoor,003.jpg,data/CAT2000/trainSet/Stimuli/Indoor/003.jpg,ROI_01,864,410,1107,722,243,312,75816
Indoor,003.jpg,data/CAT2000/trainSet/Stimuli/Indoor/003.jpg,ROI_02,487,495,666,670,179,175,31325
Indoor,005.jpg,data/CAT2000/trainSet/Stimuli/Indoor/005.jpg,ROI_00,787,80,1008,351,221,271,59891
Indoor,005.jpg,data/CAT2000/trainSet/Stimuli/Indoor/005.jpg,ROI_01,1581,359,1766,556,185,197,36445
Indoor,005.jpg,data/CAT2000/trainSet/Stimuli/Indoor/005.jpg,ROI_02,1258,402,1498,648,240,246,59040
Indoor,005.jpg,data/CAT2000/trainSet/Stimuli/Indoor/005.jpg,ROI_03,859,434,1100,667,241,233,56153
Indoor,007.jpg,data/CAT2000/trainSet/Stimuli/Indoor/007.jpg,ROI_00,883,409,1149,705,266,296,78736
Indoor,009.jpg,data/CAT2000/trainSet/Stimuli/Indoor/009.jpg,ROI_00,864,269,1119,640,255,371,94605
Indoor,011.jpg,data/CAT2000/trainSet/Stimuli/Indoor/011.jpg,ROI_00,767,372,1122,676,355,304,107920
Indoor,013.jpg,data/CAT2000/trainSet/Stimuli/Indoor/013.jpg,ROI_00,768,417,1070,852,302,435,131370
Indoor,013.jpg,data/CAT2000/trainSet/Stimuli/Indoor/013.jpg,ROI_01,936,864,1034,959,98,95,9310
Indoor,015.jpg,data/CAT2000/trainSet/Stimuli/Indoor/015.jpg,ROI_00,693,401,805,560,112,159,17808
Indoor,015.jpg,data/CAT2000/trainSet/Stimuli/Indoor/015.jpg,ROI_01,837,396,1133,652,296,256,75776
Indoor,017.jpg,data/CAT2000/trainSet/Stimuli/Indoor/017.jpg,ROI_00,776,275,1125,758,349,483,168567
Indoor,017.jpg,data/CAT2000/trainSet/Stimuli/Indoor/017.jpg,ROI_01,1322,632,1437,735,115,103,11845
Indoor,019.jpg,data/CAT2000/trainSet/Stimuli/Indoor/019.jpg,ROI_00,865,239,1330,629,465,390,181350
Indoor,019.jpg,data/CAT2000/trainSet/Stimuli/Indoor/019.jpg,ROI_01,499,255,592,357,93,102,9486
Indoor,021.jpg,data/CAT2000/trainSet/Stimuli/Indoor/021.jpg,ROI_00,805,303,1118,653,313,350,109550
Indoor,023.jpg,data/CAT2000/trainSet/Stimuli/Indoor/023.jpg,ROI_00,739,393,1137,719,398,326,129748
Indoor,025.jpg,data/CAT2000/trainSet/Stimuli/Indoor/025.jpg,ROI_00,404,109,528,217,124,108,13392
Indoor,025.jpg,data/CAT2000/trainSet/Stimuli/Indoor/025.jpg,ROI_01,701,321,1200,638,499,317,158183
Indoor,025.jpg,data/CAT2000/trainSet/Stimuli/Indoor/025.jpg,ROI_02,1488,521,1630,720,142,199,28258
Indoor,027.jpg,data/CAT2000/trainSet/Stimuli/Indoor/027.jpg,ROI_00,566,134,689,302,123,168,20664
Indoor,027.jpg,data/CAT2000/trainSet/Stimuli/Indoor/027.jpg,ROI_01,788,425,1084,645,296,220,65120
Indoor,027.jpg,data/CAT2000/trainSet/Stimuli/Indoor/027.jpg,ROI_02,745,774,918,884,173,110,19030
Indoor,029.jpg,data/CAT2000/trainSet/Stimuli/Indoor/029.jpg,ROI_00,845,359,1111,635,266,276,73416
Indoor,031.jpg,data/CAT2000/trainSet/Stimuli/Indoor/031.jpg,ROI_00,797,145,1153,631,356,486,173016
Indoor,033.jpg,data/CAT2000/trainSet/Stimuli/Indoor/033.jpg,ROI_00,846,373,1101,710,255,337,85935
Indoor,035.jpg,data/CAT2000/trainSet/Stimuli/Indoor/035.jpg,ROI_00,832,377,1327,642,495,265,131175
Indoor,037.jpg,data/CAT2000/trainSet/Stimuli/Indoor/037.jpg,ROI_00,599,271,1068,648,469,377,176813
Indoor,037.jpg,data/CAT2000/trainSet/Stimuli/Indoor/037.jpg,ROI_01,381,458,419,563,38,105,3990
Indoor,037.jpg,data/CAT2000/trainSet/Stimuli/Indoor/037.jpg,ROI_02,448,481,559,545,111,64,7104
Indoor,039.jpg,data/CAT2000/trainSet/Stimuli/Indoor/039.jpg,ROI_00,1069,213,1275,410,206,197,40582
Indoor,039.jpg,data/CAT2000/trainSet/Stimuli/Indoor/039.jpg,ROI_01,869,412,1105,667,236,255,60180
Indoor,041.jpg,data/CAT2000/trainSet/Stimuli/Indoor/041.jpg,ROI_00,1181,165,1334,350,153,185,28305
Indoor,041.jpg,data/CAT2000/trainSet/Stimuli/Indoor/041.jpg,ROI_01,940,283,1102,406,162,123,19926
Indoor,041.jpg,data/CAT2000/trainSet/Stimuli/Indoor/041.jpg,ROI_02,860,432,1345,663,485,231,112035
Indoor,043.jpg,data/CAT2000/trainSet/Stimuli/Indoor/043.jpg,ROI_00,517,155,720,391,203,236,47908
Indoor,043.jpg,data/CAT2000/trainSet/Stimuli/Indoor/043.jpg,ROI_01,802,401,1065,618,263,217,57071
Indoor,045.jpg,data/CAT2000/trainSet/Stimuli/Indoor/045.jpg,ROI_00,852,387,1149,617,297,230,68310
Indoor,045.jpg,data/CAT2000/trainSet/Stimuli/Indoor/045.jpg,ROI_01,460,566,614,680,154,114,17556
Indoor,045.jpg,data/CAT2000/trainSet/Stimuli/Indoor/045.jpg,ROI_02,1318,644,1464,799,146,155,22630
Indoor,047.jpg,data/CAT2000/trainSet/Stimuli/Indoor/047.jpg,ROI_00,828,152,1000,322,172,170,29240
Indoor,047.jpg,data/CAT2000/trainSet/Stimuli/Indoor/047.jpg,ROI_01,1179,191,1294,294,115,103,11845
Indoor,047.jpg,data/CAT2000/trainSet/Stimuli/Indoor/047.jpg,ROI_02,887,442,1069,723,182,281,51142
Indoor,047.jpg,data/CAT2000/trainSet/Stimuli/Indoor/047.jpg,ROI_03,834,774,1016,906,182,132,24024
Indoor,047.jpg,data/CAT2000/trainSet/Stimuli/Indoor/047.jpg,ROI_04,1055,821,1210,957,155,136,21080
Indoor,047.jpg,data/CAT2000/trainSet/Stimuli/Indoor/047.jpg,ROI_05,1513,919,1602,994,89,75,6675
Indoor,049.jpg,data/CAT2000/trainSet/Stimuli/Indoor/049.jpg,ROI_00,829,147,1089,620,260,473,122980
Indoor,049.jpg,data/CAT2000/trainSet/Stimuli/Indoor/049.jpg,ROI_01,881,655,1092,1020,211,365,77015
Indoor,051.jpg,data/CAT2000/trainSet/Stimuli/Indoor/051.jpg,ROI_00,1181,369,1317,512,136,143,19448
Indoor,051.jpg,data/CAT2000/trainSet/Stimuli/Indoor/051.jpg,ROI_01,791,392,1140,693,349,301,105049
Indoor,051.jpg,data/CAT2000/trainSet/Stimuli/Indoor/051.jpg,ROI_02,1176,658,1293,771,117,113,13221
Indoor,053.jpg,data/CAT2000/trainSet/Stimuli/Indoor/053.jpg,ROI_00,844,201,1210,669,366,468,171288
Indoor,055.jpg,data/CAT2000/trainSet/Stimuli/Indoor/055.jpg,ROI_00,968,177,1061,279,93,102,9486
Indoor,055.jpg,data/CAT2000/trainSet/Stimuli/Indoor/055.jpg,ROI_01,849,356,1064,647,215,291,62565
Indoor,055.jpg,data/CAT2000/trainSet/Stimuli/Indoor/055.jpg,ROI_02,1165,387,1427,605,262,218,57116
Indoor,057.jpg,data/CAT2000/trainSet/Stimuli/Indoor/057.jpg,ROI_00,835,353,1130,633,295,280,82600
Indoor,057.jpg,data/CAT2000/trainSet/Stimuli/Indoor/057.jpg,ROI_01,488,393,713,598,225,205,46125
Indoor,057.jpg,data/CAT2000/trainSet/Stimuli/Indoor/057.jpg,ROI_02,1208,504,1434,694,226,190,42940
Indoor,059.jpg,data/CAT2000/trainSet/Stimuli/Indoor/059.jpg,ROI_00,557,399,776,561,219,162,35478
Indoor,059.jpg,data/CAT2000/trainSet/Stimuli/Indoor/059.jpg,ROI_01,879,356,1177,637,298,281,83738
Indoor,061.jpg,data/CAT2000/trainSet/Stimuli/Indoor/061.jpg,ROI_00,829,389,1364,825,535,436,233260
Indoor,063.jpg,data/CAT2000/trainSet/Stimuli/Indoor/063.jpg,ROI_00,561,249,848,478,287,229,65723
Indoor,063.jpg,data/CAT2000/trainSet/Stimuli/Indoor/063.jpg,ROI_01,886,370,1174,638,288,268,77184
Indoor,065.jpg,data/CAT2000/trainSet/Stimuli/Indoor/065.jpg,ROI_00,1183,275,1382,625,199,350,69650
Indoor,065.jpg,data/CAT2000/trainSet/Stimuli/Indoor/065.jpg,ROI_01,855,391,1093,599,238,208,49504
Indoor,067.jpg,data/CAT2000/trainSet/Stimuli/Indoor/067.jpg,ROI_00,479,101,640,263,161,162,26082
Indoor,067.jpg,data/CAT2000/trainSet/Stimuli/Indoor/067.jpg,ROI_01,858,371,1082,653,224,282,63168
Indoor,067.jpg,data/CAT2000/trainSet/Stimuli/Indoor/067.jpg,ROI_02,1303,504,1410,599,107,95,10165
Indoor,069.jpg,data/CAT2000/trainSet/Stimuli/Indoor/069.jpg,ROI_00,546,366,739,523,193,157,30301
Indoor,069.jpg,data/CAT2000/trainSet/Stimuli/Indoor/069.jpg,ROI_01,1143,377,1430,571,287,194,55678
Indoor,069.jpg,data/CAT2000/trainSet/Stimuli/Indoor/069.jpg,ROI_02,845,411,1116,618,271,207,56097
Indoor,071.jpg,data/CAT2000/trainSet/Stimuli/Indoor/071.jpg,ROI_00,1200,17,1454,217,254,200,50800
Indoor,071.jpg,data/CAT2000/trainSet/Stimuli/Indoor/071.jpg,ROI_01,1392,302,1519,422,127,120,15240
Indoor,071.jpg,data/CAT2000/trainSet/Stimuli/Indoor/071.jpg,ROI_02,777,346,1091,661,314,315,98910
Indoor,073.jpg,data/CAT2000/trainSet/Stimuli/Indoor/073.jpg,ROI_00,735,261,1196,647,461,386,177946
Indoor,073.jpg,data/CAT2000/trainSet/Stimuli/Indoor/073.jpg,ROI_01,1370,915,1586,1075,216,160,34560
Indoor,075.jpg,data/CAT2000/trainSet/Stimuli/Indoor/075.jpg,ROI_00,490,373,716,562,226,189,42714
Indoor,075.jpg,data/CAT2000/trainSet/Stimuli/Indoor/075.jpg,ROI_01,775,289,1102,671,327,382,124914
Indoor,077.jpg,data/CAT2000/trainSet/Stimuli/Indoor/077.jpg,ROI_00,897,160,1052,347,155,187,28985
Indoor,077.jpg,data/CAT2000/trainSet/Stimuli/Indoor/077.jpg,ROI_01,444,152,649,388,205,236,48380
Indoor,077.jpg,data/CAT2000/trainSet/Stimuli/Indoor/077.jpg,ROI_02,881,423,1091,756,210,333,69930
Indoor,079.jpg,data/CAT2000/trainSet/Stimuli/Indoor/079.jpg,ROI_00,516,134,779,402,263,268,70484
Indoor,079.jpg,data/CAT2000/trainSet/Stimuli/Indoor/079.jpg,ROI_01,1036,193,1244,391,208,198,41184
Indoor,079.jpg,data/CAT2000/trainSet/Stimuli/Indoor/079.jpg,ROI_02,885,411,1089,665,204,254,51816
Indoor,081.jpg,data/CAT2000/trainSet/Stimuli/Indoor/081.jpg,ROI_00,537,166,738,381,201,215,43215
Indoor,081.jpg,data/CAT2000/trainSet/Stimuli/Indoor/081.jpg,ROI_01,1142,233,1265,401,123,168,20664
Indoor,081.jpg,data/CAT2000/trainSet/Stimuli/Indoor/081.jpg,ROI_02,777,372,1111,689,334,317,105878
Indoor,083.jpg,data/CAT2000/trainSet/Stimuli/Indoor/083.jpg,ROI_00,1139,129,1262,279,123,150,18450
Indoor,083.jpg,data/CAT2000/trainSet/Stimuli/Indoor/083.jpg,ROI_01,863,430,1085,896,222,466,103452
Indoor,085.jpg,data/CAT2000/trainSet/Stimuli/Indoor/085.jpg,ROI_00,809,346,1119,718,310,372,115320
Indoor,085.jpg,data/CAT2000/trainSet/Stimuli/Indoor/085.jpg,ROI_01,1142,646,1314,837,172,191,32852
Indoor,087.jpg,data/CAT2000/trainSet/Stimuli/Indoor/087.jpg,ROI_00,626,343,720,440,94,97,9118
Indoor,087.jpg,data/CAT2000/trainSet/Stimuli/Indoor/087.jpg,ROI_01,844,265,1174,765,330,500,165000
Indoor,089.jpg,data/CAT2000/trainSet/Stimuli/Indoor/089.jpg,ROI_00,789,341,1144,677,355,336,119280
Indoor,091.jpg,data/CAT2000/trainSet/Stimuli/Indoor/091.jpg,ROI_00,1516,461,1692,614,176,153,26928
Indoor,091.jpg,data/CAT2000/trainSet/Stimuli/Indoor/091.jpg,ROI_01,1389,521,1489,622,100,101,10100
Indoor,091.jpg,data/CAT2000/trainSet/Stimuli/Indoor/091.jpg,ROI_02,460,468,736,681,276,213,58788
Indoor,091.jpg,data/CAT2000/trainSet/Stimuli/Indoor/091.jpg,ROI_03,831,444,1225,725,394,281,110714
Indoor,093.jpg,data/CAT2000/trainSet/Stimuli/Indoor/093.jpg,ROI_00,699,359,1099,672,400,313,125200
Indoor,093.jpg,data/CAT2000/trainSet/Stimuli/Indoor/093.jpg,ROI_01,1138,765,1263,896,125,131,16375
Indoor,095.jpg,data/CAT2000/trainSet/Stimuli/Indoor/095.jpg,ROI_00,478,7,608,120,130,113,14690
Indoor,095.jpg,data/CAT2000/trainSet/Stimuli/Indoor/095.jpg,ROI_01,823,259,1087,632,264,373,98472
Indoor,095.jpg,data/CAT2000/trainSet/Stimuli/Indoor/095.jpg,ROI_02,1311,355,1483,465,172,110,18920
Indoor,097.jpg,data/CAT2000/trainSet/Stimuli/Indoor/097.jpg,ROI_00,862,338,1165,649,303,311,94233
Indoor,097.jpg,data/CAT2000/trainSet/Stimuli/Indoor/097.jpg,ROI_01,1182,498,1319,677,137,179,24523
Indoor,097.jpg,data/CAT2000/trainSet/Stimuli/Indoor/097.jpg,ROI_02,1403,542,1518,652,115,110,12650
Indoor,099.jpg,data/CAT2000/trainSet/Stimuli/Indoor/099.jpg,ROI_00,837,326,1163,633,326,307,100082
Indoor,099.jpg,data/CAT2000/trainSet/Stimuli/Indoor/099.jpg,ROI_01,1599,1027,1705,1080,106,53,5618
Indoor,101.jpg,data/CAT2000/trainSet/Stimuli/Indoor/101.jpg,ROI_00,1464,317,1604,452,140,135,18900
Indoor,101.jpg,data/CAT2000/trainSet/Stimuli/Indoor/101.jpg,ROI_01,847,375,1240,640,393,265,104145
Indoor,101.jpg,data/CAT2000/trainSet/Stimuli/Indoor/101.jpg,ROI_02,490,643,695,772,205,129,26445
Indoor,101.jpg,data/CAT2000/trainSet/Stimuli/Indoor/101.jpg,ROI_03,697,1026,735,1079,38,53,2014
Indoor,103.jpg,data/CAT2000/trainSet/Stimuli/Indoor/103.jpg,ROI_00,614,263,703,390,89,127,11303
Indoor,103.jpg,data/CAT2000/trainSet/Stimuli/Indoor/103.jpg,ROI_01,783,331,1120,697,337,366,123342
Indoor,105.jpg,data/CAT2000/trainSet/Stimuli/Indoor/105.jpg,ROI_00,214,422,345,576,131,154,20174
Indoor,105.jpg,data/CAT2000/trainSet/Stimuli/Indoor/105.jpg,ROI_01,738,376,1283,639,545,263,143335
Indoor,105.jpg,data/CAT2000/trainSet/Stimuli/Indoor/105.jpg,ROI_02,714,983,780,1047,66,64,4224
Indoor,107.jpg,data/CAT2000/trainSet/Stimuli/Indoor/107.jpg,ROI_00,758,355,1098,807,340,452,153680
Indoor,109.jpg,data/CAT2000/trainSet/Stimuli/Indoor/109.jpg,ROI_00,1123,455,1330,595,207,140,28980
Indoor,109.jpg,data/CAT2000/trainSet/Stimuli/Indoor/109.jpg,ROI_01,740,417,1098,673,358,256,91648
Indoor,109.jpg,data/CAT2000/trainSet/Stimuli/Indoor/109.jpg,ROI_02,371,609,532,702,161,93,14973
Indoor,109.jpg,data/CAT2000/trainSet/Stimuli/Indoor/109.jpg,ROI_03,695,1042,825,1080,130,38,4940
Indoor,111.jpg,data/CAT2000/trainSet/Stimuli/Indoor/111.jpg,ROI_00,1436,332,1541,425,105,93,9765
Indoor,111.jpg,data/CAT2000/trainSet/Stimuli/Indoor/111.jpg,ROI_01,831,305,1097,658,266,353,93898
Indoor,113.jpg,data/CAT2000/trainSet/Stimuli/Indoor/113.jpg,ROI_00,700,260,1118,637,418,377,157586
Indoor,115.jpg,data/CAT2000/trainSet/Stimuli/Indoor/115.jpg,ROI_00,889,430,1077,658,188,228,42864
Indoor,115.jpg,data/CAT2000/trainSet/Stimuli/Indoor/115.jpg,ROI_01,402,826,628,1031,226,205,46330
Indoor,115.jpg,data/CAT2000/trainSet/Stimuli/Indoor/115.jpg,ROI_02,1172,911,1287,1043,115,132,15180
Indoor,117.jpg,data/CAT2000/trainSet/Stimuli/Indoor/117.jpg,ROI_00,793,121,986,294,193,173,33389
Indoor,117.jpg,data/CAT2000/trainSet/Stimuli/Indoor/117.jpg,ROI_01,878,451,1188,686,310,235,72850
Indoor,119.jpg,data/CAT2000/trainSet/Stimuli/Indoor/119.jpg,ROI_00,724,489,819,638,95,149,14155
Indoor,119.jpg,data/CAT2000/trainSet/Stimuli/Indoor/119.jpg,ROI_01,853,455,1088,677,235,222,52170
Indoor,121.jpg,data/CAT2000/trainSet/Stimuli/Indoor/121.jpg,ROI_00,691,422,1141,768,450,346,155700
Indoor,121.jpg,data/CAT2000/trainSet/Stimuli/Indoor/121.jpg,ROI_01,1176,727,1289,833,113,106,11978
Indoor,123.jpg,data/CAT2000/trainSet/Stimuli/Indoor/123.jpg,ROI_00,843,187,974,290,131,103,13493
Indoor,123.jpg,data/CAT2000/trainSet/Stimuli/Indoor/123.jpg,ROI_01,1274,287,1370,402,96,115,11040
Indoor,123.jpg,data/CAT2000/trainSet/Stimuli/Indoor/123.jpg,ROI_02,490,326,662,477,172,151,25972
Indoor,123.jpg,data/CAT2000/trainSet/Stimuli/Indoor/123.jpg,ROI_03,856,453,1085,629,229,176,40304
Indoor,123.jpg,data/CAT2000/trainSet/Stimuli/Indoor/123.jpg,ROI_04,1399,508,1491,617,92,109,10028
Indoor,125.jpg,data/CAT2000/trainSet/Stimuli/Indoor/125.jpg,ROI_00,543,402,724,532,181,130,23530
Indoor,125.jpg,data/CAT2000/trainSet/Stimuli/Indoor/125.jpg,ROI_01,766,365,1215,668,449,303,136047
Indoor,127.jpg,data/CAT2000/trainSet/Stimuli/Indoor/127.jpg,ROI_00,730,381,1260,667,530,286,151580
Indoor,127.jpg,data/CAT2000/trainSet/Stimuli/Indoor/127.jpg,ROI_01,943,621,1054,692,111,71,7881
Indoor,129.jpg,data/CAT2000/trainSet/Stimuli/Indoor/129.jpg,ROI_00,249,195,413,339,164,144,23616
Indoor,129.jpg,data/CAT2000/trainSet/Stimuli/Indoor/129.jpg,ROI_01,808,285,1145,711,337,426,143562
Indoor,131.jpg,data/CAT2000/trainSet/Stimuli/Indoor/131.jpg,ROI_00,589,30,733,171,144,141,20304
Indoor,131.jpg,data/CAT2000/trainSet/Stimuli/Indoor/131.jpg,ROI_01,969,38,1130,186,161,148,23828
Indoor,131.jpg,data/CAT2000/trainSet/Stimuli/Indoor/131.jpg,ROI_02,880,277,1108,710,228,433,98724
Indoor,131.jpg,data/CAT2000/trainSet/Stimuli/Indoor/131.jpg,ROI_03,1113,545,1176,642,63,97,6111
Indoor,133.jpg,data/CAT2000/trainSet/Stimuli/Indoor/133.jpg,ROI_00,371,405,542,551,171,146,24966
Indoor,133.jpg,data/CAT2000/trainSet/Stimuli/Indoor/133.jpg,ROI_01,879,426,1097,660,218,234,51012
Indoor,135.jpg,data/CAT2000/trainSet/Stimuli/Indoor/135.jpg,ROI_00,864,211,1212,628,348,417,145116
Indoor,137.jpg,data/CAT2000/trainSet/Stimuli/Indoor/137.jpg,ROI_00,729,385,1156,697,427,312,133224
Indoor,139.jpg,data/CAT2000/trainSet/Stimuli/Indoor/139.jpg,ROI_00,602,313,1486,653,884,340,300560
Indoor,139.jpg,data/CAT2000/trainSet/Stimuli/Indoor/139.jpg,ROI_01,1602,582,1707,684,105,102,10710
Indoor,141.jpg,data/CAT2000/trainSet/Stimuli/Indoor/141.jpg,ROI_00,801,477,1199,831,398,354,140892
Indoor,143.jpg,data/CAT2000/trainSet/Stimuli/Indoor/143.jpg,ROI_00,816,333,1180,661,364,328,119392
Indoor,145.jpg,data/CAT2000/trainSet/Stimuli/Indoor/145.jpg,ROI_00,1094,215,1216,393,122,178,21716
Indoor,145.jpg,data/CAT2000/trainSet/Stimuli/Indoor/145.jpg,ROI_01,869,395,1213,626,344,231,79464
Indoor,145.jpg,data/CAT2000/trainSet/Stimuli/Indoor/145.jpg,ROI_02,828,809,1086,1048,258,239,61662
Indoor,147.jpg,data/CAT2000/trainSet/Stimuli/Indoor/147.jpg,ROI_00,752,392,1224,685,472,293,138296
Indoor,149.jpg,data/CAT2000/trainSet/Stimuli/Indoor/149.jpg,ROI_00,859,431,1154,724,295,293,86435
Indoor,149.jpg,data/CAT2000/trainSet/Stimuli/Indoor/149.jpg,ROI_01,465,551,613,668,148,117,17316
Indoor,151.jpg,data/CAT2000/trainSet/Stimuli/Indoor/151.jpg,ROI_00,656,190,764,332,108,142,15336
Indoor,151.jpg,data/CAT2000/trainSet/Stimuli/Indoor/151.jpg,ROI_01,896,464,1077,648,181,184,33304
Indoor,151.jpg,data/CAT2000/trainSet/Stimuli/Indoor/151.jpg,ROI_02,1011,803,1116,891,105,88,9240
Indoor,151.jpg,data/CAT2000/trainSet/Stimuli/Indoor/151.jpg,ROI_03,1390,927,1597,1050,207,123,25461
Indoor,153.jpg,data/CAT2000/trainSet/Stimuli/Indoor/153.jpg,ROI_00,1157,88,1418,259,261,171,44631
Indoor,153.jpg,data/CAT2000/trainSet/Stimuli/Indoor/153.jpg,ROI_01,568,357,1095,697,527,340,179180
Indoor,155.jpg,data/CAT2000/trainSet/Stimuli/Indoor/155.jpg,ROI_00,880,435,1113,723,233,288,67104
Indoor,157.jpg,data/CAT2000/trainSet/Stimuli/Indoor/157.jpg,ROI_00,871,338,1278,644,407,306,124542
Indoor,157.jpg,data/CAT2000/trainSet/Stimuli/Indoor/157.jpg,ROI_01,1336,527,1556,739,220,212,46640
Indoor,159.jpg,data/CAT2000/trainSet/Stimuli/Indoor/159.jpg,ROI_00,622,303,1099,658,477,355,169335
Indoor,161.jpg,data/CAT2000/trainSet/Stimuli/Indoor/161.jpg,ROI_00,875,128,1073,273,198,145,28710
Indoor,161.jpg,data/CAT2000/trainSet/Stimuli/Indoor/161.jpg,ROI_01,766,416,1186,730,420,314,131880
Indoor,163.jpg,data/CAT2000/trainSet/Stimuli/Indoor/163.jpg,ROI_00,828,339,1145,667,317,328,103976
Indoor,165.jpg,data/CAT2000/trainSet/Stimuli/Indoor/165.jpg,ROI_00,837,297,1182,670,345,373,128685
Indoor,167.jpg,data/CAT2000/trainSet/Stimuli/Indoor/167.jpg,ROI_00,1035,303,1127,408,92,105,9660
Indoor,167.jpg,data/CAT2000/trainSet/Stimuli/Indoor/167.jpg,ROI_01,760,271,1085,640,325,369,119925
Indoor,169.jpg,data/CAT2000/trainSet/Stimuli/Indoor/169.jpg,ROI_00,802,420,1146,663,344,243,83592
Indoor,171.jpg,data/CAT2000/trainSet/Stimuli/Indoor/171.jpg,ROI_00,861,436,1105,687,244,251,61244
Indoor,171.jpg,data/CAT2000/trainSet/Stimuli/Indoor/171.jpg,ROI_01,1248,524,1432,688,184,164,30176
Indoor,171.jpg,data/CAT2000/trainSet/Stimuli/Indoor/171.jpg,ROI_02,493,810,578,921,85,111,9435
Indoor,173.jpg,data/CAT2000/trainSet/Stimuli/Indoor/173.jpg,ROI_00,906,144,1119,365,213,221,47073
Indoor,173.jpg,data/CAT2000/trainSet/Stimuli/Indoor/173.jpg,ROI_01,913,421,1288,733,375,312,117000
Indoor,173.jpg,data/CAT2000/trainSet/Stimuli/Indoor/173.jpg,ROI_02,681,604,818,701,137,97,13289
Indoor,175.jpg,data/CAT2000/trainSet/Stimuli/Indoor/175.jpg,ROI_00,792,436,1178,679,386,243,93798
Indoor,175.jpg,data/CAT2000/trainSet/Stimuli/Indoor/175.jpg,ROI_01,876,794,1043,970,167,176,29392
Indoor,177.jpg,data/CAT2000/trainSet/Stimuli/Indoor/177.jpg,ROI_00,615,166,810,426,195,260,50700
Indoor,177.jpg,data/CAT2000/trainSet/Stimuli/Indoor/177.jpg,ROI_01,822,374,1129,766,307,392,120344
Indoor,179.jpg,data/CAT2000/trainSet/Stimuli/Indoor/179.jpg,ROI_00,697,351,1110,771,413,420,173460
Indoor,181.jpg,data/CAT2000/trainSet/Stimuli/Indoor/181.jpg,ROI_00,1348,264,1456,366,108,102,11016
Indoor,181.jpg,data/CAT2000/trainSet/Stimuli/Indoor/181.jpg,ROI_01,1273,449,1448,610,175,161,28175
Indoor,181.jpg,data/CAT2000/trainSet/Stimuli/Indoor/181.jpg,ROI_02,747,404,1129,834,382,430,164260
Indoor,181.jpg,data/CAT2000/trainSet/Stimuli/Indoor/181.jpg,ROI_03,1074,767,1185,850,111,83,9213
Indoor,183.jpg,data/CAT2000/trainSet/Stimuli/Indoor/183.jpg,ROI_00,797,229,1126,613,329,384,126336
Indoor,183.jpg,data/CAT2000/trainSet/Stimuli/Indoor/183.jpg,ROI_01,1140,513,1236,611,96,98,9408
Indoor,183.jpg,data/CAT2000/trainSet/Stimuli/Indoor/183.jpg,ROI_02,733,1001,843,1046,110,45,4950
Indoor,185.jpg,data/CAT2000/trainSet/Stimuli/Indoor/185.jpg,ROI_00,829,263,940,357,111,94,10434
Indoor,185.jpg,data/CAT2000/trainSet/Stimuli/Indoor/185.jpg,ROI_01,845,426,1091,781,246,355,87330
Indoor,187.jpg,data/CAT2000/trainSet/Stimuli/Indoor/187.jpg,ROI_00,1186,462,1304,573,118,111,13098
Indoor,187.jpg,data/CAT2000/trainSet/Stimuli/Indoor/187.jpg,ROI_01,885,434,1075,649,190,215,40850
Indoor,187.jpg,data/CAT2000/trainSet/Stimuli/Indoor/187.jpg,ROI_02,848,792,964,887,116,95,11020
Indoor,187.jpg,data/CAT2000/trainSet/Stimuli/Indoor/187.jpg,ROI_03,771,916,824,996,53,80,4240
Indoor,189.jpg,data/CAT2000/trainSet/Stimuli/Indoor/189.jpg,ROI_00,1036,152,1163,372,127,220,27940
Indoor,189.jpg,data/CAT2000/trainSet/Stimuli/Indoor/189.jpg,ROI_01,833,422,1080,711,247,289,71383
Indoor,189.jpg,data/CAT2000/trainSet/Stimuli/Indoor/189.jpg,ROI_02,771,960,895,1004,124,44,5456
Indoor,191.jpg,data/CAT2000/trainSet/Stimuli/Indoor/191.jpg,ROI_00,854,354,1142,704,288,350,100800
Indoor,193.jpg,data/CAT2000/trainSet/Stimuli/Indoor/193.jpg,ROI_00,457,237,612,427,155,190,29450
Indoor,193.jpg,data/CAT2000/trainSet/Stimuli/Indoor/193.jpg,ROI_01,846,451,1071,646,225,195,43875
Indoor,193.jpg,data/CAT2000/trainSet/Stimuli/Indoor/193.jpg,ROI_02,1354,908,1549,1065,195,157,30615
Indoor,195.jpg,data/CAT2000/trainSet/Stimuli/Indoor/195.jpg,ROI_00,427,256,533,352,106,96,10176
Indoor,195.jpg,data/CAT2000/trainSet/Stimuli/Indoor/195.jpg,ROI_01,734,213,1194,621,460,408,187680
Indoor,195.jpg,data/CAT2000/trainSet/Stimuli/Indoor/195.jpg,ROI_02,1338,461,1423,570,85,109,9265
Indoor,197.jpg,data/CAT2000/trainSet/Stimuli/Indoor/197.jpg,ROI_00,1258,358,1458,497,200,139,27800
Indoor,197.jpg,data/CAT2000/trainSet/Stimuli/Indoor/197.jpg,ROI_01,864,282,1230,675,366,393,143838
Indoor,199.jpg,data/CAT2000/trainSet/Stimuli/Indoor/199.jpg,ROI_00,330,282,533,431,203,149,30247
Indoor,199.jpg,data/CAT2000/trainSet/Stimuli/Indoor/199.jpg,ROI_01,737,385,1248,801,511,416,212576
Indoor,199.jpg,data/CAT2000/trainSet/Stimuli/Indoor/199.jpg,ROI_02,564,695,691,842,127,147,18669
Indoor,199.jpg,data/CAT2000/trainSet/Stimuli/Indoor/199.jpg,ROI_03,322,743,468,842,146,99,14454
OutdoorManMade,001.jpg,data/CAT2000/trainSet/Stimuli/OutdoorManMade/001.jpg,ROI_00,760,314,1052,597,292,283,82636
OutdoorManMade,001.jpg,data/CAT2000/trainSet/Stimuli/OutdoorManMade/001.jpg,ROI_01,1209,412,1336,559,127,147,18669
OutdoorManMade,001.jpg,data/CAT2000/trainSet/Stimuli/OutdoorManMade/001.jpg,ROI_02,1638,716,1812,845,174,129,22446
OutdoorManMade,001.jpg,data/CAT2000/trainSet/Stimuli/OutdoorManMade/001.jpg,ROI_03,972,720,1246,916,274,196,53704
OutdoorManMade,003.jpg,data/CAT2000/trainSet/Stimuli/OutdoorManMade/003.jpg,ROI_00,793,283,1115,663,322,380,122360
OutdoorManMade,005.jpg,data/CAT2000/trainSet/Stimuli/OutdoorManMade/005.jpg,ROI_00,848,444,1148,659,300,215,64500
OutdoorManMade,005.jpg,data/CAT2000/trainSet/Stimuli/OutdoorManMade/005.jpg,ROI_01,446,505,535,606,89,101,8989
OutdoorManMade,005.jpg,data/CAT2000/trainSet/Stimuli/OutdoorManMade/005.jpg,ROI_02,563,515,727,693,164,178,29192
OutdoorManMade,007.jpg,data/CAT2000/trainSet/Stimuli/OutdoorManMade/007.jpg,ROI_00,823,339,1206,736,383,397,152051
OutdoorManMade,009.jpg,data/CAT2000/trainSet/Stimuli/OutdoorManMade/009.jpg,ROI_00,862,275,1163,655,301,380,114380
OutdoorManMade,011.jpg,data/CAT2000/trainSet/Stimuli/OutdoorManMade/011.jpg,ROI_00,868,372,1141,677,273,305,83265
OutdoorManMade,011.jpg,data/CAT2000/trainSet/Stimuli/OutdoorManMade/011.jpg,ROI_01,690,492,951,881,261,389,101529
OutdoorManMade,013.jpg,data/CAT2000/trainSet/Stimuli/OutdoorManMade/013.jpg,ROI_00,877,158,1140,663,263,505,132815
OutdoorManMade,015.jpg,data/CAT2000/trainSet/Stimuli/OutdoorManMade/015.jpg,ROI_00,780,312,1088,648,308,336,103488
OutdoorManMade,015.jpg,data/CAT2000/trainSet/Stimuli/OutdoorManMade/015.jpg,ROI_01,878,736,1029,873,151,137,20687
OutdoorManMade,017.jpg,data/CAT2000/trainSet/Stimuli/OutdoorManMade/017.jpg,ROI_00,783,217,1318,639,535,422,225770
OutdoorManMade,019.jpg,data/CAT2000/trainSet/Stimuli/OutdoorManMade/019.jpg,ROI_00,761,229,1097,635,336,406,136416
OutdoorManMade,019.jpg,data/CAT2000/trainSet/Stimuli/OutdoorManMade/019.jpg,ROI_01,1508,554,1676,688,168,134,22512
OutdoorManMade,021.jpg,data/CAT2000/trainSet/Stimuli/OutdoorManMade/021.jpg,ROI_00,857,255,1145,674,288,419,120672
OutdoorManMade,021.jpg,data/CAT2000/trainSet/Stimuli/OutdoorManMade/021.jpg,ROI_01,640,377,789,553,149,176,26224
OutdoorManMade,023.jpg,data/CAT2000/trainSet/Stimuli/OutdoorManMade/023.jpg,ROI_00,396,250,553,437,157,187,29359
OutdoorManMade,023.jpg,data/CAT2000/trainSet/Stimuli/OutdoorManMade/023.jpg,ROI_01,880,399,1081,638,201,239,48039
OutdoorManMade,023.jpg,data/CAT2000/trainSet/Stimuli/OutdoorManMade/023.jpg,ROI_02,696,674,819,828,123,154,18942
OutdoorManMade,025.jpg,data/CAT2000/trainSet/Stimuli/OutdoorManMade/025.jpg,ROI_00,831,386,1140,770,309,384,118656
OutdoorManMade,027.jpg,data/CAT2000/trainSet/Stimuli/OutdoorManMade/027.jpg,ROI_00,646,389,1249,763,603,374,225522
OutdoorManMade,029.jpg,data/CAT2000/trainSet/Stimuli/OutdoorManMade/029.jpg,ROI_00,753,376,1097,756,344,380,130720
OutdoorManMade,029.jpg,data/CAT2000/trainSet/Stimuli/OutdoorManMade/029.jpg,ROI_01,1308,564,1480,676,172,112,19264
OutdoorManMade,029.jpg,data/CAT2000/trainSet/Stimuli/OutdoorManMade/029.jpg,ROI_02,1027,780,1151,889,124,109,13516
OutdoorManMade,031.jpg,data/CAT2000/trainSet/Stimuli/OutdoorManMade/031.jpg,ROI_00,676,413,1090,841,414,428,177192
OutdoorManMade,031.jpg,data/CAT2000/trainSet/Stimuli/OutdoorManMade/031.jpg,ROI_01,1527,667,1632,760,105,93,9765
OutdoorManMade,031.jpg,data/CAT2000/trainSet/Stimuli/OutdoorManMade/031.jpg,ROI_02,380,699,484,797,104,98,10192
OutdoorManMade,033.jpg,data/CAT2000/trainSet/Stimuli/OutdoorManMade/033.jpg,ROI_00,731,439,1082,818,351,379,133029
OutdoorManMade,033.jpg,data/CAT2000/trainSet/Stimuli/OutdoorManMade/033.jpg,ROI_01,1280,630,1456,781,176,151,26576
OutdoorManMade,035.jpg,data/CAT2000/trainSet/Stimuli/OutdoorManMade/035.jpg,ROI_00,921,262,1028,398,107,136,14552
OutdoorManMade,035.jpg,data/CAT2000/trainSet/Stimuli/OutdoorManMade/035.jpg,ROI_01,834,417,1071,632,237,215,50955
OutdoorManMade,037.jpg,data/CAT2000/trainSet/Stimuli/OutdoorManMade/037.jpg,ROI_00,784,356,1086,632,302,276,83352
OutdoorManMade,039.jpg,data/CAT2000/trainSet/Stimuli/OutdoorManMade/039.jpg,ROI_00,762,308,1114,674,352,366,128832
OutdoorManMade,041.jpg,data/CAT2000/trainSet/Stimuli/OutdoorManMade/041.jpg,ROI_00,644,405,1105,740,461,335,154435
OutdoorManMade,043.jpg,data/CAT2000/trainSet/Stimuli/OutdoorManMade/043.jpg,ROI_00,1151,349,1255,426,104,77,8008
OutdoorManMade,043.jpg,data/CAT2000/trainSet/Stimuli/OutdoorManMade/043.jpg,ROI_01,768,311,1055,671,287,360,103320
OutdoorManMade,045.jpg,data/CAT2000/trainSet/Stimuli/OutdoorManMade/045.jpg,ROI_00,863,294,1268,633,405,339,137295
OutdoorManMade,045.jpg,data/CAT2000/trainSet/Stimuli/OutdoorManMade/045.jpg,ROI_01,546,409,699,598,153,189,28917
OutdoorManMade,047.jpg,data/CAT2000/trainSet/Stimuli/OutdoorManMade/047.jpg,ROI_00,764,315,1157,602,393,287,112791
OutdoorManMade,049.jpg,data/CAT2000/trainSet/Stimuli/OutdoorManMade/049.jpg,ROI_00,1383,413,1522,528,139,115,15985
OutdoorManMade,049.jpg,data/CAT2000/trainSet/Stimuli/OutdoorManMade/049.jpg,ROI_01,329,469,486,559,157,90,14130
OutdoorManMade,049.jpg,data/CAT2000/trainSet/Stimuli/OutdoorManMade/049.jpg,ROI_02,860,412,1121,643,261,231,60291
OutdoorManMade,051.jpg,data/CAT2000/trainSet/Stimuli/OutdoorManMade/051.jpg,ROI_00,827,193,1119,873,292,680,198560
OutdoorManMade,053.jpg,data/CAT2000/trainSet/Stimuli/OutdoorManMade/053.jpg,ROI_00,850,273,1102,691,252,418,105336
OutdoorManMade,053.jpg,data/CAT2000/trainSet/Stimuli/OutdoorManMade/053.jpg,ROI_01,890,706,1056,914,166,208,34528
OutdoorManMade,053.jpg,data/CAT2000/trainSet/Stimuli/OutdoorManMade/053.jpg,ROI_02,1399,765,1520,879,121,114,13794
OutdoorManMade,055.jpg,data/CAT2000/trainSet/Stimuli/OutdoorManMade/055.jpg,ROI_00,792,412,1239,760,447,348,155556
OutdoorManMade,057.jpg,data/CAT2000/trainSet/Stimuli/OutdoorManMade/057.jpg,ROI_00,910,292,1254,777,344,485,166840
OutdoorManMade,057.jpg,data/CAT2000/trainSet/Stimuli/OutdoorManMade/057.jpg,ROI_01,1314,557,1446,678,132,121,15972
OutdoorManMade,057.jpg,data/CAT2000/trainSet/Stimuli/OutdoorManMade/057.jpg,ROI_02,509,652,601,748,92,96,8832
OutdoorManMade,057.jpg,data/CAT2000/trainSet/Stimuli/OutdoorManMade/057.jpg,ROI_03,411,831,563,984,152,153,23256
OutdoorManMade,059.jpg,data/CAT2000/trainSet/Stimuli/OutdoorManMade/059.jpg,ROI_00,890,426,1174,716,284,290,82360
OutdoorManMade,059.jpg,data/CAT2000/trainSet/Stimuli/OutdoorManMade/059.jpg,ROI_01,1323,509,1485,645,162,136,22032
OutdoorManMade,059.jpg,data/CAT2000/trainSet/Stimuli/OutdoorManMade/059.jpg,ROI_02,1198,750,1313,866,115,116,13340
OutdoorManMade,061.jpg,data/CAT2000/trainSet/Stimuli/OutdoorManMade/061.jpg,ROI_00,1230,391,1415,551,185,160,29600
OutdoorManMade,061.jpg,data/CAT2000/trainSet/Stimuli/OutdoorManMade/061.jpg,ROI_01,871,423,1088,657,217,234,50778
OutdoorManMade,061.jpg,data/CAT2000/trainSet/Stimuli/OutdoorManMade/061.jpg,ROI_02,481,769,636,942,155,173,26815
OutdoorManMade,061.jpg,data/CAT2000/trainSet/Stimuli/OutdoorManMade/061.jpg,ROI_03,1126,792,1307,985,181,193,34933
OutdoorManMade,063.jpg,data/CAT2000/trainSet/Stimuli/OutdoorManMade/063.jpg,ROI_00,784,320,878,423,94,103,9682
OutdoorManMade,063.jpg,data/CAT2000/trainSet/Stimuli/OutdoorManMade/063.jpg,ROI_01,733,435,1132,756,399,321,128079
OutdoorManMade,065.jpg,data/CAT2000/trainSet/Stimuli/OutdoorManMade/065.jpg,ROI_00,757,401,1114,665,357,264,94248
OutdoorManMade,065.jpg,data/CAT2000/trainSet/Stimuli/OutdoorManMade/065.jpg,ROI_01,254,565,512,733,258,168,43344
OutdoorManMade,067.jpg,data/CAT2000/trainSet/Stimuli/OutdoorManMade/067.jpg,ROI_00,432,361,661,562,229,201,46029
OutdoorManMade,067.jpg,data/CAT2000/trainSet/Stimuli/OutdoorManMade/067.jpg,ROI_01,859,412,1238,653,379,241,91339
OutdoorManMade,069.jpg,data/CAT2000/trainSet/Stimuli/OutdoorManMade/069.jpg,ROI_00,1141,440,1256,522,115,82,9430
OutdoorManMade,069.jpg,data/CAT2000/trainSet/Stimuli/OutdoorManMade/069.jpg,ROI_01,773,396,1109,678,336,282,94752
OutdoorManMade,069.jpg,data/CAT2000/trainSet/Stimuli/OutdoorManMade/069.jpg,ROI_02,243,741,433,916,190,175,33250
OutdoorManMade,071.jpg,data/CAT2000/trainSet/Stimuli/OutdoorManMade/071.jpg,ROI_00,668,352,1199,699,531,347,184257
OutdoorManMade,073.jpg,data/CAT2000/trainSet/Stimuli/OutdoorManMade/073.jpg,ROI_00,1251,444,1430,621,179,177,31683
OutdoorManMade,073.jpg,data/CAT2000/trainSet/Stimuli/OutdoorManMade/073.jpg,ROI_01,839,415,1222,685,383,270,103410
OutdoorManMade,075.jpg,data/CAT2000/trainSet/Stimuli/OutdoorManMade/075.jpg,ROI_00,1464,375,1688,509,224,134,30016
OutdoorManMade,075.jpg,data/CAT2000/trainSet/Stimuli/OutdoorManMade/075.jpg,ROI_01,829,389,1138,647,309,258,79722
OutdoorManMade,077.jpg,data/CAT2000/trainSet/Stimuli/OutdoorManMade/077.jpg,ROI_00,617,213,735,332,118,119,14042
OutdoorManMade,077.jpg,data/CAT2000/trainSet/Stimuli/OutdoorManMade/077.jpg,ROI_01,1337,276,1578,435,241,159,38319
OutdoorManMade,077.jpg,data/CAT2000/trainSet/Stimuli/OutdoorManMade/077.jpg,ROI_02,1256,322,1325,426,69,104,7176
OutdoorManMade,077.jpg,data/CAT2000/trainSet/Stimuli/OutdoorManMade/077.jpg,ROI_03,851,264,1123,666,272,402,109344
OutdoorManMade,079.jpg,data/CAT2000/trainSet/Stimuli/OutdoorManMade/079.jpg,ROI_00,238,471,360,612,122,141,17202
OutdoorManMade,079.jpg,data/CAT2000/trainSet/Stimuli/OutdoorManMade/079.jpg,ROI_01,806,431,1445,670,639,239,152721
OutdoorManMade,079.jpg,data/CAT2000/trainSet/Stimuli/OutdoorManMade/079.jpg,ROI_02,421,474,682,643,261,169,44109
OutdoorManMade,081.jpg,data/CAT2000/trainSet/Stimuli/OutdoorManMade/081.jpg,ROI_00,780,406,1086,723,306,317,97002
OutdoorManMade,083.jpg,data/CAT2000/trainSet/Stimuli/OutdoorManMade/083.jpg,ROI_00,802,391,1216,628,414,237,98118
OutdoorManMade,083.jpg,data/CAT2000/trainSet/Stimuli/OutdoorManMade/083.jpg,ROI_01,507,560,787,781,280,221,61880
OutdoorManMade,085.jpg,data/CAT2000/trainSet/Stimuli/OutdoorManMade/085.jpg,ROI_00,1309,275,1416,342,107,67,7169
OutdoorManMade,085.jpg,data/CAT2000/trainSet/Stimuli/OutdoorManMade/085.jpg,ROI_01,646,395,758,500,112,105,11760
OutdoorManMade,085.jpg,data/CAT2000/trainSet/Stimuli/OutdoorManMade/085.jpg,ROI_02,819,310,1152,681,333,371,123543
OutdoorManMade,087.jpg,data/CAT2000/trainSet/Stimuli/OutdoorManMade/087.jpg,ROI_00,821,168,998,369,177,201,35577
OutdoorManMade,087.jpg,data/CAT2000/trainSet/Stimuli/OutdoorManMade/087.jpg,ROI_01,1219,217,1327,322,108,105,11340
OutdoorManMade,087.jpg,data/CAT2000/trainSet/Stimuli/OutdoorManMade/087.jpg,ROI_02,559,343,693,437,134,94,12596
OutdoorManMade,087.jpg,data/CAT2000/trainSet/Stimuli/OutdoorManMade/087.jpg,ROI_03,914,427,1064,618,150,191,28650
OutdoorManMade,089.jpg,data/CAT2000/trainSet/Stimuli/OutdoorManMade/089.jpg,ROI_00,851,324,1117,618,266,294,78204
OutdoorManMade,089.jpg,data/CAT2000/trainSet/Stimuli/OutdoorManMade/089.jpg,ROI_01,620,568,771,729,151,161,24311
OutdoorManMade,091.jpg,data/CAT2000/trainSet/Stimuli/OutdoorManMade/091.jpg,ROI_00,737,437,1227,749,490,312,152880
OutdoorManMade,091.jpg,data/CAT2000/trainSet/Stimuli/OutdoorManMade/091.jpg,ROI_01,941,925,1050,1046,109,121,13189
OutdoorManMade,091.jpg,data/CAT2000/trainSet/Stimuli/OutdoorManMade/091.jpg,ROI_02,1213,961,1415,1078,202,117,23634
OutdoorManMade,093.jpg,data/CAT2000/trainSet/Stimuli/OutdoorManMade/093.jpg,ROI_00,862,413,1104,673,242,260,62920
OutdoorManMade,095.jpg,data/CAT2000/trainSet/Stimuli/OutdoorManMade/095.jpg,ROI_00,787,429,1103,756,316,327,103332
OutdoorManMade,095.jpg,data/CAT2000/trainSet/Stimuli/OutdoorManMade/095.jpg,ROI_01,1301,577,1592,789,291,212,61692
OutdoorManMade,097.jpg,data/CAT2000/trainSet/Stimuli/OutdoorManMade/097.jpg,ROI_00,839,325,1270,699,431,374,161194
OutdoorManMade,099.jpg,data/CAT2000/trainSet/Stimuli/OutdoorManMade/099.jpg,ROI_00,829,204,1167,671,338,467,157846
OutdoorManMade,101.jpg,data/CAT2000/trainSet/Stimuli/OutdoorManMade/101.jpg,ROI_00,846,422,1225,692,379,270,102330
OutdoorManMade,101.jpg,data/CAT2000/trainSet/Stimuli/OutdoorManMade/101.jpg,ROI_01,1372,651,1573,770,201,119,23919
OutdoorManMade,103.jpg,data/CAT2000/trainSet/Stimuli/OutdoorManMade/103.jpg,ROI_00,906,175,1043,302,137,127,17399
OutdoorManMade,103.jpg,data/CAT2000/trainSet/Stimuli/OutdoorManMade/103.jpg,ROI_01,845,345,1069,634,224,289,64736
OutdoorManMade,103.jpg,data/CAT2000/trainSet/Stimuli/OutdoorManMade/103.jpg,ROI_02,800,692,1060,920,260,228,59280
OutdoorManMade,103.jpg,data/CAT2000/trainSet/Stimuli/OutdoorManMade/103.jpg,ROI_03,696,1005,766,1069,70,64,4480
OutdoorManMade,105.jpg,data/CAT2000/trainSet/Stimuli/OutdoorManMade/105.jpg,ROI_00,767,385,1161,880,394,495,195030
OutdoorManMade,107.jpg,data/CAT2000/trainSet/Stimuli/OutdoorManMade/107.jpg,ROI_00,774,363,1162,745,388,382,148216
OutdoorManMade,109.jpg,data/CAT2000/trainSet/Stimuli/OutdoorManMade/109.jpg,ROI_00,818,344,1103,779,285,435,123975
OutdoorManMade,109.jpg,data/CAT2000/trainSet/Stimuli/OutdoorManMade/109.jpg,ROI_01,723,978,774,1071,51,93,4743
OutdoorManMade,111.jpg,data/CAT2000/trainSet/Stimuli/OutdoorManMade/111.jpg,ROI_00,826,227,1221,628,395,401,158395
OutdoorManMade,113.jpg,data/CAT2000/trainSet/Stimuli/OutdoorManMade/113.jpg,ROI_00,1281,315,1425,470,144,155,22320
OutdoorManMade,113.jpg,data/CAT2000/trainSet/Stimuli/OutdoorManMade/113.jpg,ROI_01,673,457,1106,817,433,360,155880
OutdoorManMade,113.jpg,data/CAT2000/trainSet/Stimuli/OutdoorManMade/113.jpg,ROI_02,1474,566,1612,730,138,164,22632
OutdoorManMade,115.jpg,data/CAT2000/trainSet/Stimuli/OutdoorManMade/115.jpg,ROI_00,1230,518,1307,616,77,98,7546
OutdoorManMade,115.jpg,data/CAT2000/trainSet/Stimuli/OutdoorManMade/115.jpg,ROI_01,872,398,1126,837,254,439,111506
OutdoorManMade,117.jpg,data/CAT2000/trainSet/Stimuli/OutdoorManMade/117.jpg,ROI_00,844,422,1017,677,173,255,44115
OutdoorManMade,117.jpg,data/CAT2000/trainSet/Stimuli/OutdoorManMade/117.jpg,ROI_01,842,800,958,897,116,97,11252
OutdoorManMade,119.jpg,data/CAT2000/trainSet/Stimuli/OutdoorManMade/119.jpg,ROI_00,875,354,1363,731,488,377,183976
OutdoorManMade,119.jpg,data/CAT2000/trainSet/Stimuli/OutdoorManMade/119.jpg,ROI_01,655,573,853,724,198,151,29898
OutdoorManMade,119.jpg,data/CAT2000/trainSet/Stimuli/OutdoorManMade/119.jpg,ROI_02,532,634,636,726,104,92,9568
OutdoorManMade,121.jpg,data/CAT2000/trainSet/Stimuli/OutdoorManMade/121.jpg,ROI_00,1334,495,1431,608,97,113,10961
OutdoorManMade,121.jpg,data/CAT2000/trainSet/Stimuli/OutdoorManMade/121.jpg,ROI_01,591,435,1103,746,512,311,159232
OutdoorManMade,123.jpg,data/CAT2000/trainSet/Stimuli/OutdoorManMade/123.jpg,ROI_00,742,471,1152,883,410,412,168920
OutdoorManMade,123.jpg,data/CAT2000/trainSet/Stimuli/OutdoorManMade/123.jpg,ROI_01,767,885,862,982,95,97,9215
OutdoorManMade,125.jpg,data/CAT2000/trainSet/Stimuli/OutdoorManMade/125.jpg,ROI_00,815,417,1104,876,289,459,132651
OutdoorManMade,125.jpg,data/CAT2000/trainSet/Stimuli/OutdoorManMade/125.jpg,ROI_01,1276,735,1372,850,96,115,11040
OutdoorManMade,127.jpg,data/CAT2000/trainSet/Stimuli/OutdoorManMade/127.jpg,ROI_00,756,415,1163,701,407,286,116402
OutdoorManMade,127.jpg,data/CAT2000/trainSet/Stimuli/OutdoorManMade/127.jpg,ROI_01,1503,686,1619,789,116,103,11948
OutdoorManMade,127.jpg,data/CAT2000/trainSet/Stimuli/OutdoorManMade/127.jpg,ROI_02,900,957,1027,1072,127,115,14605
OutdoorManMade,129.jpg,data/CAT2000/trainSet/Stimuli/OutdoorManMade/129.jpg,ROI_00,326,323,480,444,154,121,18634
OutdoorManMade,129.jpg,data/CAT2000/trainSet/Stimuli/OutdoorManMade/129.jpg,ROI_01,1396,358,1552,496,156,138,21528
OutdoorManMade,129.jpg,data/CAT2000/trainSet/Stimuli/OutdoorManMade/129.jpg,ROI_02,1131,417,1255,568,124,151,18724
OutdoorManMade,129.jpg,data/CAT2000/trainSet/Stimuli/OutdoorManMade/129.jpg,ROI_03,1607,480,1697,578,90,98,8820
OutdoorManMade,129.jpg,data/CAT2000/trainSet/Stimuli/OutdoorManMade/129.jpg,ROI_04,812,400,1115,679,303,279,84537
OutdoorManMade,129.jpg,data/CAT2000/trainSet/Stimuli/OutdoorManMade/129.jpg,ROI_05,1067,699,1201,853,134,154,20636
OutdoorManMade,131.jpg,data/CAT2000/trainSet/Stimuli/OutdoorManMade/131.jpg,ROI_00,798,443,1212,819,414,376,155664
OutdoorManMade,133.jpg,data/CAT2000/trainSet/Stimuli/OutdoorManMade/133.jpg,ROI_00,759,406,1055,615,296,209,61864
OutdoorManMade,135.jpg,data/CAT2000/trainSet/Stimuli/OutdoorManMade/135.jpg,ROI_00,804,327,1109,683,305,356,108580
OutdoorManMade,137.jpg,data/CAT2000/trainSet/Stimuli/OutdoorManMade/137.jpg,ROI_00,821,384,1125,743,304,359,109136
OutdoorManMade,139.jpg,data/CAT2000/trainSet/Stimuli/OutdoorManMade/139.jpg,ROI_00,877,466,1048,645,171,179,30609
OutdoorManMade,139.jpg,data/CAT2000/trainSet/Stimuli/OutdoorManMade/139.jpg,ROI_01,420,672,535,844,115,172,19780
OutdoorManMade,141.jpg,data/CAT2000/trainSet/Stimuli/OutdoorManMade/141.jpg,ROI_00,830,402,1045,634,215,232,49880
OutdoorManMade,141.jpg,data/CAT2000/trainSet/Stimuli/OutdoorManMade/141.jpg,ROI_01,486,810,694,1022,208,212,44096
OutdoorManMade,143.jpg,data/CAT2000/trainSet/Stimuli/OutdoorManMade/143.jpg,ROI_00,797,344,1159,661,362,317,114754
OutdoorManMade,143.jpg,data/CAT2000/trainSet/Stimuli/OutdoorManMade/143.jpg,ROI_01,1441,454,1595,594,154,140,21560
OutdoorManMade,145.jpg,data/CAT2000/trainSet/Stimuli/OutdoorManMade/145.jpg,ROI_00,812,410,1160,767,348,357,124236
OutdoorManMade,145.jpg,data/CAT2000/trainSet/Stimuli/OutdoorManMade/145.jpg,ROI_01,1174,577,1280,676,106,99,10494
OutdoorManMade,147.jpg,data/CAT2000/trainSet/Stimuli/OutdoorManMade/147.jpg,ROI_00,775,43,1088,736,313,693,216909
OutdoorManMade,147.jpg,data/CAT2000/trainSet/Stimuli/OutdoorManMade/147.jpg,ROI_01,813,945,987,1077,174,132,22968
OutdoorManMade,149.jpg,data/CAT2000/trainSet/Stimuli/OutdoorManMade/149.jpg,ROI_00,842,408,1156,746,314,338,106132
OutdoorManMade,151.jpg,data/CAT2000/trainSet/Stimuli/OutdoorManMade/151.jpg,ROI_00,774,441,1210,701,436,260,113360
OutdoorManMade,153.jpg,data/CAT2000/trainSet/Stimuli/OutdoorManMade/153.jpg,ROI_00,840,397,1110,630,270,233,62910
OutdoorManMade,153.jpg,data/CAT2000/trainSet/Stimuli/OutdoorManMade/153.jpg,ROI_01,1368,475,1620,689,252,214,53928
OutdoorManMade,155.jpg,data/CAT2000/trainSet/Stimuli/OutdoorManMade/155.jpg,ROI_00,876,346,1134,692,258,346,89268
OutdoorManMade,157.jpg,data/CAT2000/trainSet/Stimuli/OutdoorManMade/157.jpg,ROI_00,827,446,1188,748,361,302,109022
OutdoorManMade,157.jpg,data/CAT2000/trainSet/Stimuli/OutdoorManMade/157.jpg,ROI_01,518,575,665,700,147,125,18375
OutdoorManMade,159.jpg,data/CAT2000/trainSet/Stimuli/OutdoorManMade/159.jpg,ROI_00,871,363,1346,917,475,554,263150
OutdoorManMade,161.jpg,data/CAT2000/trainSet/Stimuli/OutdoorManMade/161.jpg,ROI_00,881,431,1091,668,210,237,49770
OutdoorManMade,163.jpg,data/CAT2000/trainSet/Stimuli/OutdoorManMade/163.jpg,ROI_00,571,382,1064,649,493,267,131631
OutdoorManMade,165.jpg,data/CAT2000/trainSet/Stimuli/OutdoorManMade/165.jpg,ROI_00,839,443,1154,731,315,288,90720
OutdoorManMade,165.jpg,data/CAT2000/trainSet/Stimuli/OutdoorManMade/165.jpg,ROI_01,947,806,1182,931,235,125,29375
OutdoorManMade,167.jpg,data/CAT2000/trainSet/Stimuli/OutdoorManMade/167.jpg,ROI_00,830,332,1138,642,308,310,95480
OutdoorManMade,167.jpg,data/CAT2000/trainSet/Stimuli/OutdoorManMade/167.jpg,ROI_01,1223,698,1383,844,160,146,23360
OutdoorManMade,169.jpg,data/CAT2000/trainSet/Stimuli/OutdoorManMade/169.jpg,ROI_00,457,217,698,394,241,177,42657
OutdoorManMade,169.jpg,data/CAT2000/trainSet/Stimuli/OutdoorManMade/169.jpg,ROI_01,857,449,1053,641,196,192,37632
OutdoorManMade,171.jpg,data/CAT2000/trainSet/Stimuli/OutdoorManMade/171.jpg,ROI_00,848,371,1139,810,291,439,127749
OutdoorManMade,173.jpg,data/CAT2000/trainSet/Stimuli/OutdoorManMade/173.jpg,ROI_00,813,371,1096,659,283,288,81504
OutdoorManMade,173.jpg,data/CAT2000/trainSet/Stimuli/OutdoorManMade/173.jpg,ROI_01,1258,418,1502,647,244,229,55876
OutdoorManMade,173.jpg,data/CAT2000/trainSet/Stimuli/OutdoorManMade/173.jpg,ROI_02,317,463,480,619,163,156,25428
OutdoorManMade,175.jpg,data/CAT2000/trainSet/Stimuli/OutdoorManMade/175.jpg,ROI_00,726,353,1244,756,518,403,208754
OutdoorManMade,175.jpg,data/CAT2000/trainSet/Stimuli/OutdoorManMade/175.jpg,ROI_01,1331,721,1488,876,157,155,24335
OutdoorManMade,177.jpg,data/CAT2000/trainSet/Stimuli/OutdoorManMade/177.jpg,ROI_00,1287,434,1457,539,170,105,17850
OutdoorManMade,177.jpg,data/CAT2000/trainSet/Stimuli/OutdoorManMade/177.jpg,ROI_01,648,425,1191,690,543,265,143895
OutdoorManMade,179.jpg,data/CAT2000/trainSet/Stimuli/OutdoorManMade/179.jpg,ROI_00,596,326,850,557,254,231,58674
OutdoorManMade,179.jpg,data/CAT2000/trainSet/Stimuli/OutdoorManMade/179.jpg,ROI_01,900,443,1040,611,140,168,23520
OutdoorManMade,181.jpg,data/CAT2000/trainSet/Stimuli/OutdoorManMade/181.jpg,ROI_00,884,475,1349,731,465,256,119040
OutdoorManMade,183.jpg,data/CAT2000/trainSet/Stimuli/OutdoorManMade/183.jpg,ROI_00,818,483,1087,662,269,179,48151
OutdoorManMade,183.jpg,data/CAT2000/trainSet/Stimuli/OutdoorManMade/183.jpg,ROI_01,747,987,808,1035,61,48,2928
OutdoorManMade,185.jpg,data/CAT2000/trainSet/Stimuli/OutdoorManMade/185.jpg,ROI_00,838,222,1170,658,332,436,144752
OutdoorManMade,185.jpg,data/CAT2000/trainSet/Stimuli/OutdoorManMade/185.jpg,ROI_01,776,955,826,1020,50,65,3250
OutdoorManMade,187.jpg,data/CAT2000/trainSet/Stimuli/OutdoorManMade/187.jpg,ROI_00,481,414,579,506,98,92,9016
OutdoorManMade,187.jpg,data/CAT2000/trainSet/Stimuli/OutdoorManMade/187.jpg,ROI_01,848,431,1072,686,224,255,57120
OutdoorManMade,189.jpg,data/CAT2000/trainSet/Stimuli/OutdoorManMade/189.jpg,ROI_00,796,301,1107,771,311,470,146170
OutdoorManMade,189.jpg,data/CAT2000/trainSet/Stimuli/OutdoorManMade/189.jpg,ROI_01,703,668,784,781,81,113,9153
OutdoorManMade,191.jpg,data/CAT2000/trainSet/Stimuli/OutdoorManMade/191.jpg,ROI_00,834,437,1168,795,334,358,119572
OutdoorManMade,193.jpg,data/CAT2000/trainSet/Stimuli/OutdoorManMade/193.jpg,ROI_00,820,401,1104,699,284,298,84632
OutdoorManMade,195.jpg,data/CAT2000/trainSet/Stimuli/OutdoorManMade/195.jpg,ROI_00,862,412,1122,675,260,263,68380
OutdoorManMade,195.jpg,data/CAT2000/trainSet/Stimuli/OutdoorManMade/195.jpg,ROI_01,613,470,771,639,158,169,26702
OutdoorManMade,195.jpg,data/CAT2000/trainSet/Stimuli/OutdoorManMade/195.jpg,ROI_02,1065,753,1253,918,188,165,31020
OutdoorManMade,197.jpg,data/CAT2000/trainSet/Stimuli/OutdoorManMade/197.jpg,ROI_00,1502,378,1700,587,198,209,41382
OutdoorManMade,197.jpg,data/CAT2000/trainSet/Stimuli/OutdoorManMade/197.jpg,ROI_01,839,406,1086,630,247,224,55328
OutdoorManMade,199.jpg,data/CAT2000/trainSet/Stimuli/OutdoorManMade/199.jpg,ROI_00,735,270,1142,780,407,510,207570
OutdoorManMade,199.jpg,data/CAT2000/trainSet/Stimuli/OutdoorManMade/199.jpg,ROI_01,433,584,536,744,103,160,16480
OutdoorNatural,001.jpg,data/CAT2000/trainSet/Stimuli/OutdoorNatural/001.jpg,ROI_00,758,445,1118,752,360,307,110520
OutdoorNatural,003.jpg,data/CAT2000/trainSet/Stimuli/OutdoorNatural/003.jpg,ROI_00,762,362,1088,682,326,320,104320
OutdoorNatural,005.jpg,data/CAT2000/trainSet/Stimuli/OutdoorNatural/005.jpg,ROI_00,858,414,1186,698,328,284,93152
OutdoorNatural,005.jpg,data/CAT2000/trainSet/Stimuli/OutdoorNatural/005.jpg,ROI_01,1238,668,1529,825,291,157,45687
OutdoorNatural,007.jpg,data/CAT2000/trainSet/Stimuli/OutdoorNatural/007.jpg,ROI_00,760,308,1103,679,343,371,127253
OutdoorNatural,007.jpg,data/CAT2000/trainSet/Stimuli/OutdoorNatural/007.jpg,ROI_01,1228,452,1401,627,173,175,30275
OutdoorNatural,009.jpg,data/CAT2000/trainSet/Stimuli/OutdoorNatural/009.jpg,ROI_00,820,358,1164,737,344,379,130376
OutdoorNatural,011.jpg,data/CAT2000/trainSet/Stimuli/OutdoorNatural/011.jpg,ROI_00,1130,303,1322,474,192,171,32832
OutdoorNatural,011.jpg,data/CAT2000/trainSet/Stimuli/OutdoorNatural/011.jpg,ROI_01,768,361,1081,648,313,287,89831
OutdoorNatural,013.jpg,data/CAT2000/trainSet/Stimuli/OutdoorNatural/013.jpg,ROI_00,413,87,507,206,94,119,11186
OutdoorNatural,013.jpg,data/CAT2000/trainSet/Stimuli/OutdoorNatural/013.jpg,ROI_01,955,71,1097,226,142,155,22010
OutdoorNatural,013.jpg,data/CAT2000/trainSet/Stimuli/OutdoorNatural/013.jpg,ROI_02,820,430,1167,668,347,238,82586
OutdoorNatural,013.jpg,data/CAT2000/trainSet/Stimuli/OutdoorNatural/013.jpg,ROI_03,1210,718,1353,863,143,145,20735
OutdoorNatural,015.jpg,data/CAT2000/trainSet/Stimuli/OutdoorNatural/015.jpg,ROI_00,872,395,1104,660,232,265,61480
OutdoorNatural,015.jpg,data/CAT2000/trainSet/Stimuli/OutdoorNatural/015.jpg,ROI_01,1245,434,1479,634,234,200,46800
OutdoorNatural,015.jpg,data/CAT2000/trainSet/Stimuli/OutdoorNatural/015.jpg,ROI_02,683,532,814,677,131,145,18995
OutdoorNatural,017.jpg,data/CAT2000/trainSet/Stimuli/OutdoorNatural/017.jpg,ROI_00,878,418,1062,662,184,244,44896
OutdoorNatural,017.jpg,data/CAT2000/trainSet/Stimuli/OutdoorNatural/017.jpg,ROI_01,559,648,761,851,202,203,41006
OutdoorNatural,017.jpg,data/CAT2000/trainSet/Stimuli/OutdoorNatural/017.jpg,ROI_02,1250,667,1510,834,260,167,43420
OutdoorNatural,017.jpg,data/CAT2000/trainSet/Stimuli/OutdoorNatural/017.jpg,ROI_03,855,706,1020,876,165,170,28050
OutdoorNatural,019.jpg,data/CAT2000/trainSet/Stimuli/OutdoorNatural/019.jpg,ROI_00,843,390,1092,628,249,238,59262
OutdoorNatural,019.jpg,data/CAT2000/trainSet/Stimuli/OutdoorNatural/019.jpg,ROI_01,1265,615,1381,726,116,111,12876
OutdoorNatural,021.jpg,data/CAT2000/trainSet/Stimuli/OutdoorNatural/021.jpg,ROI_00,516,388,1222,669,706,281,198386
OutdoorNatural,023.jpg,data/CAT2000/trainSet/Stimuli/OutdoorNatural/023.jpg,ROI_00,569,305,1059,822,490,517,253330
OutdoorNatural,023.jpg,data/CAT2000/trainSet/Stimuli/OutdoorNatural/023.jpg,ROI_01,336,440,440,529,104,89,9256
OutdoorNatural,025.jpg,data/CAT2000/trainSet/Stimuli/OutdoorNatural/025.jpg,ROI_00,620,80,1222,635,602,555,334110
OutdoorNatural,027.jpg,data/CAT2000/trainSet/Stimuli/OutdoorNatural/027.jpg,ROI_00,766,372,1103,677,337,305,102785
OutdoorNatural,029.jpg,data/CAT2000/trainSet/Stimuli/OutdoorNatural/029.jpg,ROI_00,867,417,1413,689,546,272,148512
OutdoorNatural,029.jpg,data/CAT2000/trainSet/Stimuli/OutdoorNatural/029.jpg,ROI_01,641,472,839,652,198,180,35640
OutdoorNatural,031.jpg,data/CAT2000/trainSet/Stimuli/OutdoorNatural/031.jpg,ROI_00,884,388,1253,665,369,277,102213
OutdoorNatural,033.jpg,data/CAT2000/trainSet/Stimuli/OutdoorNatural/033.jpg,ROI_00,680,392,1151,856,471,464,218544
OutdoorNatural,033.jpg,data/CAT2000/trainSet/Stimuli/OutdoorNatural/033.jpg,ROI_01,1256,603,1365,712,109,109,11881
OutdoorNatural,035.jpg,data/CAT2000/trainSet/Stimuli/OutdoorNatural/035.jpg,ROI_00,852,416,1103,693,251,277,69527
OutdoorNatural,035.jpg,data/CAT2000/trainSet/Stimuli/OutdoorNatural/035.jpg,ROI_01,428,603,585,738,157,135,21195
OutdoorNatural,037.jpg,data/CAT2000/trainSet/Stimuli/OutdoorNatural/037.jpg,ROI_00,732,441,1251,732,519,291,151029
OutdoorNatural,039.jpg,data/CAT2000/trainSet/Stimuli/OutdoorNatural/039.jpg,ROI_00,665,487,810,595,145,108,15660
OutdoorNatural,039.jpg,data/CAT2000/trainSet/Stimuli/OutdoorNatural/039.jpg,ROI_01,831,435,1127,722,296,287,84952
OutdoorNatural,041.jpg,data/CAT2000/trainSet/Stimuli/OutdoorNatural/041.jpg,ROI_00,758,235,1082,656,324,421,136404
OutdoorNatural,041.jpg,data/CAT2000/trainSet/Stimuli/OutdoorNatural/041.jpg,ROI_01,912,748,994,850,82,102,8364
OutdoorNatural,043.jpg,data/CAT2000/trainSet/Stimuli/OutdoorNatural/043.jpg,ROI_00,784,329,1242,853,458,524,239992
OutdoorNatural,045.jpg,data/CAT2000/trainSet/Stimuli/OutdoorNatural/045.jpg,ROI_00,1073,426,1262,590,189,164,30996
OutdoorNatural,045.jpg,data/CAT2000/trainSet/Stimuli/OutdoorNatural/045.jpg,ROI_01,890,440,1072,615,182,175,31850
OutdoorNatural,045.jpg,data/CAT2000/trainSet/Stimuli/OutdoorNatural/045.jpg,ROI_02,1230,932,1331,1042,101,110,11110
OutdoorNatural,047.jpg,data/CAT2000/trainSet/Stimuli/OutdoorNatural/047.jpg,ROI_00,699,337,1043,664,344,327,112488
OutdoorNatural,047.jpg,data/CAT2000/trainSet/Stimuli/OutdoorNatural/047.jpg,ROI_01,1175,520,1306,613,131,93,12183
OutdoorNatural,049.jpg,data/CAT2000/trainSet/Stimuli/OutdoorNatural/049.jpg,ROI_00,784,414,1157,771,373,357,133161
OutdoorNatural,051.jpg,data/CAT2000/trainSet/Stimuli/OutdoorNatural/051.jpg,ROI_00,830,218,1133,720,303,502,152106
OutdoorNatural,053.jpg,data/CAT2000/trainSet/Stimuli/OutdoorNatural/053.jpg,ROI_00,875,367,1110,758,235,391,91885
OutdoorNatural,055.jpg,data/CAT2000/trainSet/Stimuli/OutdoorNatural/055.jpg,ROI_00,777,312,1152,631,375,319,119625
OutdoorNatural,057.jpg,data/CAT2000/trainSet/Stimuli/OutdoorNatural/057.jpg,ROI_00,872,426,1137,666,265,240,63600
OutdoorNatural,057.jpg,data/CAT2000/trainSet/Stimuli/OutdoorNatural/057.jpg,ROI_01,1376,450,1589,682,213,232,49416
OutdoorNatural,057.jpg,data/CAT2000/trainSet/Stimuli/OutdoorNatural/057.jpg,ROI_02,496,490,757,658,261,168,43848
OutdoorNatural,059.jpg,data/CAT2000/trainSet/Stimuli/OutdoorNatural/059.jpg,ROI_00,1168,249,1270,372,102,123,12546
OutdoorNatural,059.jpg,data/CAT2000/trainSet/Stimuli/OutdoorNatural/059.jpg,ROI_01,901,360,1136,650,235,290,68150
OutdoorNatural,061.jpg,data/CAT2000/trainSet/Stimuli/OutdoorNatural/061.jpg,ROI_00,565,302,793,566,228,264,60192
OutdoorNatural,061.jpg,data/CAT2000/trainSet/Stimuli/OutdoorNatural/061.jpg,ROI_01,848,417,1140,632,292,215,62780
OutdoorNatural,061.jpg,data/CAT2000/trainSet/Stimuli/OutdoorNatural/061.jpg,ROI_02,1172,512,1379,749,207,237,49059
OutdoorNatural,063.jpg,data/CAT2000/trainSet/Stimuli/OutdoorNatural/063.jpg,ROI_00,727,391,1114,819,387,428,165636
OutdoorNatural,065.jpg,data/CAT2000/trainSet/Stimuli/OutdoorNatural/065.jpg,ROI_00,853,400,1194,818,341,418,142538
OutdoorNatural,065.jpg,data/CAT2000/trainSet/Stimuli/OutdoorNatural/065.jpg,ROI_01,539,605,685,721,146,116,16936
OutdoorNatural,067.jpg,data/CAT2000/trainSet/Stimuli/OutdoorNatural/067.jpg,ROI_00,1362,242,1613,441,251,199,49949
OutdoorNatural,067.jpg,data/CAT2000/trainSet/Stimuli/OutdoorNatural/067.jpg,ROI_01,653,385,1112,643,459,258,118422
OutdoorNatural,069.jpg,data/CAT2000/trainSet/Stimuli/OutdoorNatural/069.jpg,ROI_00,693,350,1146,780,453,430,194790
OutdoorNatural,071.jpg,data/CAT2000/trainSet/Stimuli/OutdoorNatural/071.jpg,ROI_00,847,313,1145,768,298,455,135590
OutdoorNatural,073.jpg,data/CAT2000/trainSet/Stimuli/OutdoorNatural/073.jpg,ROI_00,828,352,1176,640,348,288,100224
OutdoorNatural,075.jpg,data/CAT2000/trainSet/Stimuli/OutdoorNatural/075.jpg,ROI_00,833,367,1151,754,318,387,123066
OutdoorNatural,077.jpg,data/CAT2000/trainSet/Stimuli/OutdoorNatural/077.jpg,ROI_00,779,385,1129,777,350,392,137200
OutdoorNatural,079.jpg,data/CAT2000/trainSet/Stimuli/OutdoorNatural/079.jpg,ROI_00,1174,293,1412,487,238,194,46172
OutdoorNatural,079.jpg,data/CAT2000/trainSet/Stimuli/OutdoorNatural/079.jpg,ROI_01,713,387,1067,625,354,238,84252
OutdoorNatural,079.jpg,data/CAT2000/trainSet/Stimuli/OutdoorNatural/079.jpg,ROI_02,423,487,598,627,175,140,24500
OutdoorNatural,081.jpg,data/CAT2000/trainSet/Stimuli/OutdoorNatural/081.jpg,ROI_00,867,430,1324,782,457,352,160864
OutdoorNatural,083.jpg,data/CAT2000/trainSet/Stimuli/OutdoorNatural/083.jpg,ROI_00,479,433,585,525,106,92,9752
OutdoorNatural,083.jpg,data/CAT2000/trainSet/Stimuli/OutdoorNatural/083.jpg,ROI_01,840,407,1152,663,312,256,79872
OutdoorNatural,085.jpg,data/CAT2000/trainSet/Stimuli/OutdoorNatural/085.jpg,ROI_00,753,413,1092,682,339,269,91191
OutdoorNatural,087.jpg,data/CAT2000/trainSet/Stimuli/OutdoorNatural/087.jpg,ROI_00,594,352,765,530,171,178,30438
OutdoorNatural,087.jpg,data/CAT2000/trainSet/Stimuli/OutdoorNatural/087.jpg,ROI_01,781,337,1283,628,502,291,146082
OutdoorNatural,089.jpg,data/CAT2000/trainSet/Stimuli/OutdoorNatural/089.jpg,ROI_00,1164,263,1390,523,226,260,58760
OutdoorNatural,089.jpg,data/CAT2000/trainSet/Stimuli/OutdoorNatural/089.jpg,ROI_01,822,346,1111,640,289,294,84966
OutdoorNatural,091.jpg,data/CAT2000/trainSet/Stimuli/OutdoorNatural/091.jpg,ROI_00,832,336,1270,706,438,370,162060
OutdoorNatural,091.jpg,data/CAT2000/trainSet/Stimuli/OutdoorNatural/091.jpg,ROI_01,1433,735,1539,813,106,78,8268
OutdoorNatural,093.jpg,data/CAT2000/trainSet/Stimuli/OutdoorNatural/093.jpg,ROI_00,567,200,740,334,173,134,23182
OutdoorNatural,093.jpg,data/CAT2000/trainSet/Stimuli/OutdoorNatural/093.jpg,ROI_01,845,273,1104,638,259,365,94535
OutdoorNatural,095.jpg,data/CAT2000/trainSet/Stimuli/OutdoorNatural/095.jpg,ROI_00,728,331,1178,781,450,450,202500
OutdoorNatural,097.jpg,data/CAT2000/trainSet/Stimuli/OutdoorNatural/097.jpg,ROI_00,774,287,1300,721,526,434,228284
OutdoorNatural,099.jpg,data/CAT2000/trainSet/Stimuli/OutdoorNatural/099.jpg,ROI_00,786,376,1125,661,339,285,96615
OutdoorNatural,101.jpg,data/CAT2000/trainSet/Stimuli/OutdoorNatural/101.jpg,ROI_00,640,213,1109,625,469,412,193228
OutdoorNatural,101.jpg,data/CAT2000/trainSet/Stimuli/OutdoorNatural/101.jpg,ROI_01,713,1046,788,1079,75,33,2475
OutdoorNatural,103.jpg,data/CAT2000/trainSet/Stimuli/OutdoorNatural/103.jpg,ROI_00,785,370,1171,653,386,283,109238
OutdoorNatural,105.jpg,data/CAT2000/trainSet/Stimuli/OutdoorNatural/105.jpg,ROI_00,869,244,1322,578,453,334,151302
OutdoorNatural,107.jpg,data/CAT2000/trainSet/Stimuli/OutdoorNatural/107.jpg,ROI_00,856,361,1111,643,255,282,71910
OutdoorNatural,109.jpg,data/CAT2000/trainSet/Stimuli/OutdoorNatural/109.jpg,ROI_00,833,395,1213,694,380,299,113620
OutdoorNatural,109.jpg,data/CAT2000/trainSet/Stimuli/OutdoorNatural/109.jpg,ROI_01,777,959,888,1012,111,53,5883
OutdoorNatural,111.jpg,data/CAT2000/trainSet/Stimuli/OutdoorNatural/111.jpg,ROI_00,773,403,1106,777,333,374,124542
OutdoorNatural,113.jpg,data/CAT2000/trainSet/Stimuli/OutdoorNatural/113.jpg,ROI_00,779,254,1135,789,356,535,190460
OutdoorNatural,115.jpg,data/CAT2000/trainSet/Stimuli/OutdoorNatural/115.jpg,ROI_00,1090,337,1283,495,193,158,30494
OutdoorNatural,115.jpg,data/CAT2000/trainSet/Stimuli/OutdoorNatural/115.jpg,ROI_01,773,386,1078,668,305,282,86010
OutdoorNatural,115.jpg,data/CAT2000/trainSet/Stimuli/OutdoorNatural/115.jpg,ROI_02,535,511,673,624,138,113,15594
OutdoorNatural,117.jpg,data/CAT2000/trainSet/Stimuli/OutdoorNatural/117.jpg,ROI_00,849,447,1150,968,301,521,156821
OutdoorNatural,119.jpg,data/CAT2000/trainSet/Stimuli/OutdoorNatural/119.jpg,ROI_00,861,322,1154,675,293,353,103429
OutdoorNatural,121.jpg,data/CAT2000/trainSet/Stimuli/OutdoorNatural/121.jpg,ROI_00,1169,427,1313,545,144,118,16992
OutdoorNatural,121.jpg,data/CAT2000/trainSet/Stimuli/OutdoorNatural/121.jpg,ROI_01,686,423,1140,701,454,278,126212
OutdoorNatural,123.jpg,data/CAT2000/trainSet/Stimuli/OutdoorNatural/123.jpg,ROI_00,812,237,1267,720,455,483,219765
OutdoorNatural,125.jpg,data/CAT2000/trainSet/Stimuli/OutdoorNatural/125.jpg,ROI_00,643,338,1043,635,400,297,118800
OutdoorNatural,127.jpg,data/CAT2000/trainSet/Stimuli/OutdoorNatural/127.jpg,ROI_00,739,346,1133,675,394,329,129626
OutdoorNatural,129.jpg,data/CAT2000/trainSet/Stimuli/OutdoorNatural/129.jpg,ROI_00,815,406,1100,648,285,242,68970
OutdoorNatural,129.jpg,data/CAT2000/trainSet/Stimuli/OutdoorNatural/129.jpg,ROI_01,991,799,1090,879,99,80,7920
OutdoorNatural,131.jpg,data/CAT2000/trainSet/Stimuli/OutdoorNatural/131.jpg,ROI_00,829,381,1179,695,350,314,109900
OutdoorNatural,133.jpg,data/CAT2000/trainSet/Stimuli/OutdoorNatural/133.jpg,ROI_00,813,368,1121,769,308,401,123508
OutdoorNatural,135.jpg,data/CAT2000/trainSet/Stimuli/OutdoorNatural/135.jpg,ROI_00,766,336,1140,629,374,293,109582
OutdoorNatural,137.jpg,data/CAT2000/trainSet/Stimuli/OutdoorNatural/137.jpg,ROI_00,826,419,1145,683,319,264,84216
OutdoorNatural,139.jpg,data/CAT2000/trainSet/Stimuli/OutdoorNatural/139.jpg,ROI_00,854,361,1140,761,286,400,114400
OutdoorNatural,141.jpg,data/CAT2000/trainSet/Stimuli/OutdoorNatural/141.jpg,ROI_00,812,235,1145,673,333,438,145854
OutdoorNatural,143.jpg,data/CAT2000/trainSet/Stimuli/OutdoorNatural/143.jpg,ROI_00,764,443,1143,755,379,312,118248
OutdoorNatural,145.jpg,data/CAT2000/trainSet/Stimuli/OutdoorNatural/145.jpg,ROI_00,810,412,1183,750,373,338,126074
OutdoorNatural,147.jpg,data/CAT2000/trainSet/Stimuli/OutdoorNatural/147.jpg,ROI_00,1156,374,1293,498,137,124,16988
OutdoorNatural,147.jpg,data/CAT2000/trainSet/Stimuli/OutdoorNatural/147.jpg,ROI_01,704,437,1058,654,354,217,76818
OutdoorNatural,149.jpg,data/CAT2000/trainSet/Stimuli/OutdoorNatural/149.jpg,ROI_00,836,475,1114,784,278,309,85902
OutdoorNatural,151.jpg,data/CAT2000/trainSet/Stimuli/OutdoorNatural/151.jpg,ROI_00,760,417,851,496,91,79,7189
OutdoorNatural,151.jpg,data/CAT2000/trainSet/Stimuli/OutdoorNatural/151.jpg,ROI_01,874,331,1101,644,227,313,71051
OutdoorNatural,153.jpg,data/CAT2000/trainSet/Stimuli/OutdoorNatural/153.jpg,ROI_00,885,366,1107,631,222,265,58830
OutdoorNatural,155.jpg,data/CAT2000/trainSet/Stimuli/OutdoorNatural/155.jpg,ROI_00,657,331,1196,668,539,337,181643
OutdoorNatural,157.jpg,data/CAT2000/trainSet/Stimuli/OutdoorNatural/157.jpg,ROI_00,819,388,1128,682,309,294,90846
OutdoorNatural,159.jpg,data/CAT2000/trainSet/Stimuli/OutdoorNatural/159.jpg,ROI_00,1037,290,1097,389,60,99,5940
OutdoorNatural,159.jpg,data/CAT2000/trainSet/Stimuli/OutdoorNatural/159.jpg,ROI_01,875,420,1086,699,211,279,58869
OutdoorNatural,159.jpg,data/CAT2000/trainSet/Stimuli/OutdoorNatural/159.jpg,ROI_02,812,867,1057,1076,245,209,51205
OutdoorNatural,161.jpg,data/CAT2000/trainSet/Stimuli/OutdoorNatural/161.jpg,ROI_00,815,416,1119,641,304,225,68400
OutdoorNatural,163.jpg,data/CAT2000/trainSet/Stimuli/OutdoorNatural/163.jpg,ROI_00,739,344,1053,718,314,374,117436
OutdoorNatural,165.jpg,data/CAT2000/trainSet/Stimuli/OutdoorNatural/165.jpg,ROI_00,1172,273,1362,413,190,140,26600
OutdoorNatural,165.jpg,data/CAT2000/trainSet/Stimuli/OutdoorNatural/165.jpg,ROI_01,858,398,1121,686,263,288,75744
OutdoorNatural,167.jpg,data/CAT2000/trainSet/Stimuli/OutdoorNatural/167.jpg,ROI_00,813,415,1097,712,284,297,84348
OutdoorNatural,169.jpg,data/CAT2000/trainSet/Stimuli/OutdoorNatural/169.jpg,ROI_00,833,177,1067,635,234,458,107172
OutdoorNatural,169.jpg,data/CAT2000/trainSet/Stimuli/OutdoorNatural/169.jpg,ROI_01,980,781,1059,867,79,86,6794
OutdoorNatural,171.jpg,data/CAT2000/trainSet/Stimuli/OutdoorNatural/171.jpg,ROI_00,863,387,1171,662,308,275,84700
OutdoorNatural,173.jpg,data/CAT2000/trainSet/Stimuli/OutdoorNatural/173.jpg,ROI_00,716,515,815,627,99,112,11088
OutdoorNatural,173.jpg,data/CAT2000/trainSet/Stimuli/OutdoorNatural/173.jpg,ROI_01,877,457,1179,686,302,229,69158
OutdoorNatural,173.jpg,data/CAT2000/trainSet/Stimuli/OutdoorNatural/173.jpg,ROI_02,1224,677,1339,778,115,101,11615
OutdoorNatural,175.jpg,data/CAT2000/trainSet/Stimuli/OutdoorNatural/175.jpg,ROI_00,807,399,1181,687,374,288,107712
OutdoorNatural,177.jpg,data/CAT2000/trainSet/Stimuli/OutdoorNatural/177.jpg,ROI_00,850,437,1094,660,244,223,54412
OutdoorNatural,177.jpg,data/CAT2000/trainSet/Stimuli/OutdoorNatural/177.jpg,ROI_01,1306,537,1479,656,173,119,20587
OutdoorNatural,177.jpg,data/CAT2000/trainSet/Stimuli/OutdoorNatural/177.jpg,ROI_02,1141,677,1335,838,194,161,31234
OutdoorNatural,179.jpg,data/CAT2000/trainSet/Stimuli/OutdoorNatural/179.jpg,ROI_00,1293,381,1517,587,224,206,46144
OutdoorNatural,179.jpg,data/CAT2000/trainSet/Stimuli/OutdoorNatural/179.jpg,ROI_01,391,333,1075,644,684,311,212724
OutdoorNatural,181.jpg,data/CAT2000/trainSet/Stimuli/OutdoorNatural/181.jpg,ROI_00,1527,412,1636,515,109,103,11227
OutdoorNatural,181.jpg,data/CAT2000/trainSet/Stimuli/OutdoorNatural/181.jpg,ROI_01,866,424,1021,629,155,205,31775
OutdoorNatural,181.jpg,data/CAT2000/trainSet/Stimuli/OutdoorNatural/181.jpg,ROI_02,550,514,833,811,283,297,84051
OutdoorNatural,181.jpg,data/CAT2000/trainSet/Stimuli/OutdoorNatural/181.jpg,ROI_03,751,919,882,1030,131,111,14541
OutdoorNatural,183.jpg,data/CAT2000/trainSet/Stimuli/OutdoorNatural/183.jpg,ROI_00,560,196,762,534,202,338,68276
OutdoorNatural,183.jpg,data/CAT2000/trainSet/Stimuli/OutdoorNatural/183.jpg,ROI_01,883,460,1077,637,194,177,34338
OutdoorNatural,183.jpg,data/CAT2000/trainSet/Stimuli/OutdoorNatural/183.jpg,ROI_02,723,967,830,1023,107,56,5992
OutdoorNatural,185.jpg,data/CAT2000/trainSet/Stimuli/OutdoorNatural/185.jpg,ROI_00,518,281,1026,638,508,357,181356
OutdoorNatural,185.jpg,data/CAT2000/trainSet/Stimuli/OutdoorNatural/185.jpg,ROI_01,1043,432,1145,510,102,78,7956
OutdoorNatural,187.jpg,data/CAT2000/trainSet/Stimuli/OutdoorNatural/187.jpg,ROI_00,804,448,1075,754,271,306,82926
OutdoorNatural,187.jpg,data/CAT2000/trainSet/Stimuli/OutdoorNatural/187.jpg,ROI_01,1006,759,1103,848,97,89,8633
OutdoorNatural,187.jpg,data/CAT2000/trainSet/Stimuli/OutdoorNatural/187.jpg,ROI_02,699,911,827,1018,128,107,13696
OutdoorNatural,189.jpg,data/CAT2000/trainSet/Stimuli/OutdoorNatural/189.jpg,ROI_00,868,431,1268,688,400,257,102800
OutdoorNatural,189.jpg,data/CAT2000/trainSet/Stimuli/OutdoorNatural/189.jpg,ROI_01,765,991,852,1022,87,31,2697
OutdoorNatural,191.jpg,data/CAT2000/trainSet/Stimuli/OutdoorNatural/191.jpg,ROI_00,736,364,1136,702,400,338,135200
OutdoorNatural,193.jpg,data/CAT2000/trainSet/Stimuli/OutdoorNatural/193.jpg,ROI_00,620,339,1383,741,763,402,306726
OutdoorNatural,195.jpg,data/CAT2000/trainSet/Stimuli/OutdoorNatural/195.jpg,ROI_00,679,311,767,445,88,134,11792
OutdoorNatural,195.jpg,data/CAT2000/trainSet/Stimuli/OutdoorNatural/195.jpg,ROI_01,852,315,1093,698,241,383,92303
OutdoorNatural,197.jpg,data/CAT2000/trainSet/Stimuli/OutdoorNatural/197.jpg,ROI_00,1487,247,1771,459,284,212,60208
OutdoorNatural,197.jpg,data/CAT2000/trainSet/Stimuli/OutdoorNatural/197.jpg,ROI_01,269,312,385,413,116,101,11716
OutdoorNatural,197.jpg,data/CAT2000/trainSet/Stimuli/OutdoorNatural/197.jpg,ROI_02,716,234,1056,593,340,359,122060
OutdoorNatural,199.jpg,data/CAT2000/trainSet/Stimuli/OutdoorNatural/199.jpg,ROI_00,883,468,1299,795,416,327,136032
OutdoorNatural,199.jpg,data/CAT2000/trainSet/Stimuli/OutdoorNatural/199.jpg,ROI_01,1346,808,1483,953,137,145,19865
Social,001.jpg,data/CAT2000/trainSet/Stimuli/Social/001.jpg,ROI_00,1293,280,1426,468,133,188,25004
Social,001.jpg,data/CAT2000/trainSet/Stimuli/Social/001.jpg,ROI_01,568,344,1204,761,636,417,265212
Social,001.jpg,data/CAT2000/trainSet/Stimuli/Social/001.jpg,ROI_02,1527,911,1631,1001,104,90,9360
Social,003.jpg,data/CAT2000/trainSet/Stimuli/Social/003.jpg,ROI_00,789,182,1062,437,273,255,69615
Social,003.jpg,data/CAT2000/trainSet/Stimuli/Social/003.jpg,ROI_01,1096,222,1299,426,203,204,41412
Social,003.jpg,data/CAT2000/trainSet/Stimuli/Social/003.jpg,ROI_02,886,453,1049,623,163,170,27710
Social,005.jpg,data/CAT2000/trainSet/Stimuli/Social/005.jpg,ROI_00,877,142,1232,645,355,503,178565
Social,007.jpg,data/CAT2000/trainSet/Stimuli/Social/007.jpg,ROI_00,1404,455,1587,683,183,228,41724
Social,007.jpg,data/CAT2000/trainSet/Stimuli/Social/007.jpg,ROI_01,787,483,1336,873,549,390,214110
Social,007.jpg,data/CAT2000/trainSet/Stimuli/Social/007.jpg,ROI_02,571,628,680,729,109,101,11009
Social,009.jpg,data/CAT2000/trainSet/Stimuli/Social/009.jpg,ROI_00,1072,229,1247,326,175,97,16975
Social,009.jpg,data/CAT2000/trainSet/Stimuli/Social/009.jpg,ROI_01,489,344,1084,671,595,327,194565
Social,009.jpg,data/CAT2000/trainSet/Stimuli/Social/009.jpg,ROI_02,1228,356,1422,557,194,201,38994
Social,011.jpg,data/CAT2000/trainSet/Stimuli/Social/011.jpg,ROI_00,1167,403,1261,525,94,122,11468
Social,011.jpg,data/CAT2000/trainSet/Stimuli/Social/011.jpg,ROI_01,647,347,1166,756,519,409,212271
Social,013.jpg,data/CAT2000/trainSet/Stimuli/Social/013.jpg,ROI_00,755,147,1019,337,264,190,50160
Social,013.jpg,data/CAT2000/trainSet/Stimuli/Social/013.jpg,ROI_01,454,143,650,349,196,206,40376
Social,013.jpg,data/CAT2000/trainSet/Stimuli/Social/013.jpg,ROI_02,1159,314,1354,485,195,171,33345
Social,013.jpg,data/CAT2000/trainSet/Stimuli/Social/013.jpg,ROI_03,829,414,1030,595,201,181,36381
Social,015.jpg,data/CAT2000/trainSet/Stimuli/Social/015.jpg,ROI_00,1414,195,1572,372,158,177,27966
Social,015.jpg,data/CAT2000/trainSet/Stimuli/Social/015.jpg,ROI_01,829,272,1088,603,259,331,85729
Social,015.jpg,data/CAT2000/trainSet/Stimuli/Social/015.jpg,ROI_02,312,496,563,659,251,163,40913
Social,017.jpg,data/CAT2000/trainSet/Stimuli/Social/017.jpg,ROI_00,724,286,1239,731,515,445,229175
Social,019.jpg,data/CAT2000/trainSet/Stimuli/Social/019.jpg,ROI_00,1099,234,1262,343,163,109,17767
Social,019.jpg,data/CAT2000/trainSet/Stimuli/Social/019.jpg,ROI_01,680,197,1087,681,407,484,196988
Social,019.jpg,data/CAT2000/trainSet/Stimuli/Social/019.jpg,ROI_02,1469,511,1637,641,168,130,21840
Social,021.jpg,data/CAT2000/trainSet/Stimuli/Social/021.jpg,ROI_00,841,126,1231,611,390,485,189150
Social,021.jpg,data/CAT2000/trainSet/Stimuli/Social/021.jpg,ROI_01,1266,287,1400,518,134,231,30954
Social,021.jpg,data/CAT2000/trainSet/Stimuli/Social/021.jpg,ROI_02,752,478,839,601,87,123,10701
Social,021.jpg,data/CAT2000/trainSet/Stimuli/Social/021.jpg,ROI_03,776,612,865,671,89,59,5251
Social,023.jpg,data/CAT2000/trainSet/Stimuli/Social/023.jpg,ROI_00,708,102,1361,651,653,549,358497
Social,023.jpg,data/CAT2000/trainSet/Stimuli/Social/023.jpg,ROI_01,435,282,691,440,256,158,40448
Social,023.jpg,data/CAT2000/trainSet/Stimuli/Social/023.jpg,ROI_02,767,722,877,851,110,129,14190
Social,025.jpg,data/CAT2000/trainSet/Stimuli/Social/025.jpg,ROI_00,819,39,1001,134,182,95,17290
Social,025.jpg,data/CAT2000/trainSet/Stimuli/Social/025.jpg,ROI_01,1237,30,1463,289,226,259,58534
Social,025.jpg,data/CAT2000/trainSet/Stimuli/Social/025.jpg,ROI_02,863,388,1093,658,230,270,62100
Social,027.jpg,data/CAT2000/trainSet/Stimuli/Social/027.jpg,ROI_00,762,136,1073,639,311,503,156433
Social,027.jpg,data/CAT2000/trainSet/Stimuli/Social/027.jpg,ROI_01,739,721,894,957,155,236,36580
Social,029.jpg,data/CAT2000/trainSet/Stimuli/Social/029.jpg,ROI_00,508,180,643,352,135,172,23220
Social,029.jpg,data/CAT2000/trainSet/Stimuli/Social/029.jpg,ROI_01,1390,261,1521,456,131,195,25545
Social,029.jpg,data/CAT2000/trainSet/Stimuli/Social/029.jpg,ROI_02,1078,313,1196,452,118,139,16402
Social,029.jpg,data/CAT2000/trainSet/Stimuli/Social/029.jpg,ROI_03,769,411,1076,772,307,361,110827
Social,029.jpg,data/CAT2000/trainSet/Stimuli/Social/029.jpg,ROI_04,1429,922,1542,1015,113,93,10509
Social,031.jpg,data/CAT2000/trainSet/Stimuli/Social/031.jpg,ROI_00,1124,194,1257,328,133,134,17822
Social,031.jpg,data/CAT2000/trainSet/Stimuli/Social/031.jpg,ROI_01,851,199,1078,396,227,197,44719
Social,031.jpg,data/CAT2000/trainSet/Stimuli/Social/031.jpg,ROI_02,596,217,776,464,180,247,44460
Social,031.jpg,data/CAT2000/trainSet/Stimuli/Social/031.jpg,ROI_03,668,458,1052,798,384,340,130560
Social,033.jpg,data/CAT2000/trainSet/Stimuli/Social/033.jpg,ROI_00,1242,92,1545,291,303,199,60297
Social,033.jpg,data/CAT2000/trainSet/Stimuli/Social/033.jpg,ROI_01,849,88,1037,347,188,259,48692
Social,033.jpg,data/CAT2000/trainSet/Stimuli/Social/033.jpg,ROI_02,726,175,823,288,97,113,10961
Social,033.jpg,data/CAT2000/trainSet/Stimuli/Social/033.jpg,ROI_03,823,421,1084,673,261,252,65772
Social,035.jpg,data/CAT2000/trainSet/Stimuli/Social/035.jpg,ROI_00,1330,358,1452,510,122,152,18544
Social,035.jpg,data/CAT2000/trainSet/Stimuli/Social/035.jpg,ROI_01,665,403,1072,652,407,249,101343
Social,035.jpg,data/CAT2000/trainSet/Stimuli/Social/035.jpg,ROI_02,786,806,945,1001,159,195,31005
Social,037.jpg,data/CAT2000/trainSet/Stimuli/Social/037.jpg,ROI_00,582,253,702,425,120,172,20640
Social,037.jpg,data/CAT2000/trainSet/Stimuli/Social/037.jpg,ROI_01,1086,261,1276,496,190,235,44650
Social,037.jpg,data/CAT2000/trainSet/Stimuli/Social/037.jpg,ROI_02,1351,352,1466,518,115,166,19090
Social,037.jpg,data/CAT2000/trainSet/Stimuli/Social/037.jpg,ROI_03,788,348,1059,621,271,273,73983
Social,039.jpg,data/CAT2000/trainSet/Stimuli/Social/039.jpg,ROI_00,345,172,553,382,208,210,43680
Social,039.jpg,data/CAT2000/trainSet/Stimuli/Social/039.jpg,ROI_01,1186,353,1305,454,119,101,12019
Social,039.jpg,data/CAT2000/trainSet/Stimuli/Social/039.jpg,ROI_02,890,395,1154,601,264,206,54384
Social,039.jpg,data/CAT2000/trainSet/Stimuli/Social/039.jpg,ROI_03,1454,628,1546,764,92,136,12512
Social,041.jpg,data/CAT2000/trainSet/Stimuli/Social/041.jpg,ROI_00,163,150,405,391,242,241,58322
Social,041.jpg,data/CAT2000/trainSet/Stimuli/Social/041.jpg,ROI_01,1579,223,1683,388,104,165,17160
Social,041.jpg,data/CAT2000/trainSet/Stimuli/Social/041.jpg,ROI_02,1163,267,1373,415,210,148,31080
Social,041.jpg,data/CAT2000/trainSet/Stimuli/Social/041.jpg,ROI_03,703,251,1086,593,383,342,130986
Social,043.jpg,data/CAT2000/trainSet/Stimuli/Social/043.jpg,ROI_00,728,345,1200,681,472,336,158592
Social,045.jpg,data/CAT2000/trainSet/Stimuli/Social/045.jpg,ROI_00,348,37,414,150,66,113,7458
Social,045.jpg,data/CAT2000/trainSet/Stimuli/Social/045.jpg,ROI_01,1171,117,1287,341,116,224,25984
Social,045.jpg,data/CAT2000/trainSet/Stimuli/Social/045.jpg,ROI_02,508,296,655,424,147,128,18816
Social,045.jpg,data/CAT2000/trainSet/Stimuli/Social/045.jpg,ROI_03,896,238,1153,627,257,389,99973
Social,047.jpg,data/CAT2000/trainSet/Stimuli/Social/047.jpg,ROI_00,831,423,1226,624,395,201,79395
Social,047.jpg,data/CAT2000/trainSet/Stimuli/Social/047.jpg,ROI_01,309,430,752,662,443,232,102776
Social,049.jpg,data/CAT2000/trainSet/Stimuli/Social/049.jpg,ROI_00,885,442,1114,707,229,265,60685
Social,049.jpg,data/CAT2000/trainSet/Stimuli/Social/049.jpg,ROI_01,1342,590,1486,674,144,84,12096
Social,049.jpg,data/CAT2000/trainSet/Stimuli/Social/049.jpg,ROI_02,1144,569,1315,743,171,174,29754
Social,051.jpg,data/CAT2000/trainSet/Stimuli/Social/051.jpg,ROI_00,1177,284,1391,436,214,152,32528
Social,051.jpg,data/CAT2000/trainSet/Stimuli/Social/051.jpg,ROI_01,428,320,626,493,198,173,34254
Social,051.jpg,data/CAT2000/trainSet/Stimuli/Social/051.jpg,ROI_02,699,272,1090,616,391,344,134504
Social,053.jpg,data/CAT2000/trainSet/Stimuli/Social/053.jpg,ROI_00,270,375,584,590,314,215,67510
Social,053.jpg,data/CAT2000/trainSet/Stimuli/Social/053.jpg,ROI_01,1470,470,1668,606,198,136,26928
Social,053.jpg,data/CAT2000/trainSet/Stimuli/Social/053.jpg,ROI_02,845,393,1245,733,400,340,136000
Social,055.jpg,data/CAT2000/trainSet/Stimuli/Social/055.jpg,ROI_00,779,446,1089,740,310,294,91140
Social,055.jpg,data/CAT2000/trainSet/Stimuli/Social/055.jpg,ROI_01,1090,494,1395,768,305,274,83570
Social,055.jpg,data/CAT2000/trainSet/Stimuli/Social/055.jpg,ROI_02,630,618,764,719,134,101,13534
Social,057.jpg,data/CAT2000/trainSet/Stimuli/Social/057.jpg,ROI_00,670,309,822,433,152,124,18848
Social,057.jpg,data/CAT2000/trainSet/Stimuli/Social/057.jpg,ROI_01,847,166,1272,764,425,598,254150
Social,059.jpg,data/CAT2000/trainSet/Stimuli/Social/059.jpg,ROI_00,524,126,683,287,159,161,25599
Social,059.jpg,data/CAT2000/trainSet/Stimuli/Social/059.jpg,ROI_01,851,202,1025,368,174,166,28884
Social,059.jpg,data/CAT2000/trainSet/Stimuli/Social/059.jpg,ROI_02,654,301,798,400,144,99,14256
Social,059.jpg,data/CAT2000/trainSet/Stimuli/Social/059.jpg,ROI_03,1418,494,1525,581,107,87,9309
Social,059.jpg,data/CAT2000/trainSet/Stimuli/Social/059.jpg,ROI_04,874,457,1095,711,221,254,56134
Social,059.jpg,data/CAT2000/trainSet/Stimuli/Social/059.jpg,ROI_05,703,684,818,796,115,112,12880
Social,061.jpg,data/CAT2000/trainSet/Stimuli/Social/061.jpg,ROI_00,839,183,1033,413,194,230,44620
Social,061.jpg,data/CAT2000/trainSet/Stimuli/Social/061.jpg,ROI_01,1376,188,1677,408,301,220,66220
Social,061.jpg,data/CAT2000/trainSet/Stimuli/Social/061.jpg,ROI_02,601,244,818,441,217,197,42749
Social,061.jpg,data/CAT2000/trainSet/Stimuli/Social/061.jpg,ROI_03,895,418,1051,601,156,183,28548
Social,063.jpg,data/CAT2000/trainSet/Stimuli/Social/063.jpg,ROI_00,561,223,652,317,91,94,8554
Social,063.jpg,data/CAT2000/trainSet/Stimuli/Social/063.jpg,ROI_01,865,367,1196,660,331,293,96983
Social,063.jpg,data/CAT2000/trainSet/Stimuli/Social/063.jpg,ROI_02,415,498,584,612,169,114,19266
Social,063.jpg,data/CAT2000/trainSet/Stimuli/Social/063.jpg,ROI_03,1220,503,1504,666,284,163,46292
Social,065.jpg,data/CAT2000/trainSet/Stimuli/Social/065.jpg,ROI_00,1465,293,1616,399,151,106,16006
Social,065.jpg,data/CAT2000/trainSet/Stimuli/Social/065.jpg,ROI_01,598,296,842,453,244,157,38308
Social,065.jpg,data/CAT2000/trainSet/Stimuli/Social/065.jpg,ROI_02,1198,410,1349,527,151,117,17667
Social,065.jpg,data/CAT2000/trainSet/Stimuli/Social/065.jpg,ROI_03,883,291,1109,680,226,389,87914
Social,067.jpg,data/CAT2000/trainSet/Stimuli/Social/067.jpg,ROI_00,1146,215,1505,432,359,217,77903
Social,067.jpg,data/CAT2000/trainSet/Stimuli/Social/067.jpg,ROI_01,621,367,779,470,158,103,16274
Social,067.jpg,data/CAT2000/trainSet/Stimuli/Social/067.jpg,ROI_02,784,282,1057,638,273,356,97188
Social,069.jpg,data/CAT2000/trainSet/Stimuli/Social/069.jpg,ROI_00,756,80,1065,669,309,589,182001
Social,069.jpg,data/CAT2000/trainSet/Stimuli/Social/069.jpg,ROI_01,841,747,938,847,97,100,9700
Social,071.jpg,data/CAT2000/trainSet/Stimuli/Social/071.jpg,ROI_00,699,93,858,304,159,211,33549
Social,071.jpg,data/CAT2000/trainSet/Stimuli/Social/071.jpg,ROI_01,1089,355,1224,491,135,136,18360
Social,071.jpg,data/CAT2000/trainSet/Stimuli/Social/071.jpg,ROI_02,898,490,1061,643,163,153,24939
Social,071.jpg,data/CAT2000/trainSet/Stimuli/Social/071.jpg,ROI_03,564,789,669,894,105,105,11025
Social,071.jpg,data/CAT2000/trainSet/Stimuli/Social/071.jpg,ROI_04,1205,805,1385,1007,180,202,36360
Social,073.jpg,data/CAT2000/trainSet/Stimuli/Social/073.jpg,ROI_00,1174,257,1324,448,150,191,28650
Social,073.jpg,data/CAT2000/trainSet/Stimuli/Social/073.jpg,ROI_01,362,300,705,564,343,264,90552
Social,073.jpg,data/CAT2000/trainSet/Stimuli/Social/073.jpg,ROI_02,781,226,1063,655,282,429,120978
Social,075.jpg,data/CAT2000/trainSet/Stimuli/Social/075.jpg,ROI_00,1251,203,1414,390,163,187,30481
Social,075.jpg,data/CAT2000/trainSet/Stimuli/Social/075.jpg,ROI_01,743,286,1190,639,447,353,157791
Social,075.jpg,data/CAT2000/trainSet/Stimuli/Social/075.jpg,ROI_02,399,437,495,531,96,94,9024
Social,075.jpg,data/CAT2000/trainSet/Stimuli/Social/075.jpg,ROI_03,675,752,822,862,147,110,16170
Social,075.jpg,data/CAT2000/trainSet/Stimuli/Social/075.jpg,ROI_04,846,778,989,927,143,149,21307
Social,077.jpg,data/CAT2000/trainSet/Stimuli/Social/077.jpg,ROI_00,1180,94,1333,246,153,152,23256
Social,077.jpg,data/CAT2000/trainSet/Stimuli/Social/077.jpg,ROI_01,709,133,889,260,180,127,22860
Social,077.jpg,data/CAT2000/trainSet/Stimuli/Social/077.jpg,ROI_02,775,445,1059,647,284,202,57368
Social,077.jpg,data/CAT2000/trainSet/Stimuli/Social/077.jpg,ROI_03,1070,595,1270,793,200,198,39600
Social,079.jpg,data/CAT2000/trainSet/Stimuli/Social/079.jpg,ROI_00,1526,135,1672,246,146,111,16206
Social,079.jpg,data/CAT2000/trainSet/Stimuli/Social/079.jpg,ROI_01,1200,338,1421,505,221,167,36907
Social,079.jpg,data/CAT2000/trainSet/Stimuli/Social/079.jpg,ROI_02,689,346,1091,663,402,317,127434
Social,081.jpg,data/CAT2000/trainSet/Stimuli/Social/081.jpg,ROI_00,1344,387,1507,535,163,148,24124
Social,081.jpg,data/CAT2000/trainSet/Stimuli/Social/081.jpg,ROI_01,1142,354,1332,595,190,241,45790
Social,081.jpg,data/CAT2000/trainSet/Stimuli/Social/081.jpg,ROI_02,465,360,809,658,344,298,102512
Social,081.jpg,data/CAT2000/trainSet/Stimuli/Social/081.jpg,ROI_03,836,368,1055,682,219,314,68766
Social,083.jpg,data/CAT2000/trainSet/Stimuli/Social/083.jpg,ROI_00,1277,81,1433,281,156,200,31200
Social,083.jpg,data/CAT2000/trainSet/Stimuli/Social/083.jpg,ROI_01,842,82,1046,400,204,318,64872
Social,083.jpg,data/CAT2000/trainSet/Stimuli/Social/083.jpg,ROI_02,575,190,751,421,176,231,40656
Social,083.jpg,data/CAT2000/trainSet/Stimuli/Social/083.jpg,ROI_03,856,404,1057,642,201,238,47838
Social,085.jpg,data/CAT2000/trainSet/Stimuli/Social/085.jpg,ROI_00,692,334,1276,769,584,435,254040
Social,087.jpg,data/CAT2000/trainSet/Stimuli/Social/087.jpg,ROI_00,1306,190,1527,424,221,234,51714
Social,087.jpg,data/CAT2000/trainSet/Stimuli/Social/087.jpg,ROI_01,754,233,1056,642,302,409,123518
Social,087.jpg,data/CAT2000/trainSet/Stimuli/Social/087.jpg,ROI_02,1121,710,1213,813,92,103,9476
Social,089.jpg,data/CAT2000/trainSet/Stimuli/Social/089.jpg,ROI_00,752,265,1114,701,362,436,157832
Social,089.jpg,data/CAT2000/trainSet/Stimuli/Social/089.jpg,ROI_01,1191,793,1313,883,122,90,10980
Social,091.jpg,data/CAT2000/trainSet/Stimuli/Social/091.jpg,ROI_00,498,162,747,387,249,225,56025
Social,091.jpg,data/CAT2000/trainSet/Stimuli/Social/091.jpg,ROI_01,1518,182,1703,434,185,252,46620
Social,091.jpg,data/CAT2000/trainSet/Stimuli/Social/091.jpg,ROI_02,796,393,1064,622,268,229,61372
Social,091.jpg,data/CAT2000/trainSet/Stimuli/Social/091.jpg,ROI_03,1045,637,1150,760,105,123,12915
Social,093.jpg,data/CAT2000/trainSet/Stimuli/Social/093.jpg,ROI_00,528,202,1101,586,573,384,220032
Social,093.jpg,data/CAT2000/trainSet/Stimuli/Social/093.jpg,ROI_01,1476,442,1607,562,131,120,15720
Social,095.jpg,data/CAT2000/trainSet/Stimuli/Social/095.jpg,ROI_00,755,154,965,428,210,274,57540
Social,095.jpg,data/CAT2000/trainSet/Stimuli/Social/095.jpg,ROI_01,1500,240,1660,389,160,149,23840
Social,095.jpg,data/CAT2000/trainSet/Stimuli/Social/095.jpg,ROI_02,1152,301,1343,505,191,204,38964
Social,095.jpg,data/CAT2000/trainSet/Stimuli/Social/095.jpg,ROI_03,884,444,1059,635,175,191,33425
Social,097.jpg,data/CAT2000/trainSet/Stimuli/Social/097.jpg,ROI_00,409,232,495,342,86,110,9460
Social,097.jpg,data/CAT2000/trainSet/Stimuli/Social/097.jpg,ROI_01,698,148,1081,598,383,450,172350
Social,099.jpg,data/CAT2000/trainSet/Stimuli/Social/099.jpg,ROI_00,378,445,602,601,224,156,34944
Social,099.jpg,data/CAT2000/trainSet/Stimuli/Social/099.jpg,ROI_01,765,387,1238,688,473,301,142373
Social,101.jpg,data/CAT2000/trainSet/Stimuli/Social/101.jpg,ROI_00,587,248,734,438,147,190,27930
Social,101.jpg,data/CAT2000/trainSet/Stimuli/Social/101.jpg,ROI_01,1395,381,1541,479,146,98,14308
Social,101.jpg,data/CAT2000/trainSet/Stimuli/Social/101.jpg,ROI_02,813,352,1113,682,300,330,99000
Social,103.jpg,data/CAT2000/trainSet/Stimuli/Social/103.jpg,ROI_00,1282,329,1346,425,64,96,6144
Social,103.jpg,data/CAT2000/trainSet/Stimuli/Social/103.jpg,ROI_01,865,201,1206,608,341,407,138787
Social,103.jpg,data/CAT2000/trainSet/Stimuli/Social/103.jpg,ROI_02,805,961,871,1037,66,76,5016
Social,105.jpg,data/CAT2000/trainSet/Stimuli/Social/105.jpg,ROI_00,846,269,1189,679,343,410,140630
Social,105.jpg,data/CAT2000/trainSet/Stimuli/Social/105.jpg,ROI_01,564,299,799,464,235,165,38775
Social,107.jpg,data/CAT2000/trainSet/Stimuli/Social/107.jpg,ROI_00,847,148,1249,623,402,475,190950
Social,107.jpg,data/CAT2000/trainSet/Stimuli/Social/107.jpg,ROI_01,589,414,754,588,165,174,28710
Social,109.jpg,data/CAT2000/trainSet/Stimuli/Social/109.jpg,ROI_00,1214,158,1368,325,154,167,25718
Social,109.jpg,data/CAT2000/trainSet/Stimuli/Social/109.jpg,ROI_01,867,126,1109,625,242,499,120758
Social,109.jpg,data/CAT2000/trainSet/Stimuli/Social/109.jpg,ROI_02,1372,216,1541,374,169,158,26702
Social,111.jpg,data/CAT2000/trainSet/Stimuli/Social/111.jpg,ROI_00,811,214,1392,725,581,511,296891
Social,113.jpg,data/CAT2000/trainSet/Stimuli/Social/113.jpg,ROI_00,778,326,1242,622,464,296,137344
Social,113.jpg,data/CAT2000/trainSet/Stimuli/Social/113.jpg,ROI_01,1305,453,1437,584,132,131,17292
Social,115.jpg,data/CAT2000/trainSet/Stimuli/Social/115.jpg,ROI_00,1126,268,1285,413,159,145,23055
Social,115.jpg,data/CAT2000/trainSet/Stimuli/Social/115.jpg,ROI_01,552,297,685,532,133,235,31255
Social,115.jpg,data/CAT2000/trainSet/Stimuli/Social/115.jpg,ROI_02,745,300,1074,653,329,353,116137
Social,117.jpg,data/CAT2000/trainSet/Stimuli/Social/117.jpg,ROI_00,720,405,1144,834,424,429,181896
Social,119.jpg,data/CAT2000/trainSet/Stimuli/Social/119.jpg,ROI_00,1364,134,1549,316,185,182,33670
Social,119.jpg,data/CAT2000/trainSet/Stimuli/Social/119.jpg,ROI_01,877,387,1167,625,290,238,69020
Social,119.jpg,data/CAT2000/trainSet/Stimuli/Social/119.jpg,ROI_02,1523,455,1677,599,154,144,22176
Social,119.jpg,data/CAT2000/trainSet/Stimuli/Social/119.jpg,ROI_03,528,472,715,607,187,135,25245
Social,121.jpg,data/CAT2000/trainSet/Stimuli/Social/121.jpg,ROI_00,1145,201,1379,385,234,184,43056
Social,121.jpg,data/CAT2000/trainSet/Stimuli/Social/121.jpg,ROI_01,619,280,1128,626,509,346,176114
Social,121.jpg,data/CAT2000/trainSet/Stimuli/Social/121.jpg,ROI_02,282,334,438,450,156,116,18096
Social,123.jpg,data/CAT2000/trainSet/Stimuli/Social/123.jpg,ROI_00,783,200,1095,390,312,190,59280
Social,123.jpg,data/CAT2000/trainSet/Stimuli/Social/123.jpg,ROI_01,783,416,1230,822,447,406,181482
Social,123.jpg,data/CAT2000/trainSet/Stimuli/Social/123.jpg,ROI_02,697,851,880,1067,183,216,39528
Social,125.jpg,data/CAT2000/trainSet/Stimuli/Social/125.jpg,ROI_00,755,181,1237,647,482,466,224612
Social,125.jpg,data/CAT2000/trainSet/Stimuli/Social/125.jpg,ROI_01,519,177,693,370,174,193,33582
Social,127.jpg,data/CAT2000/trainSet/Stimuli/Social/127.jpg,ROI_00,1234,133,1405,390,171,257,43947
Social,127.jpg,data/CAT2000/trainSet/Stimuli/Social/127.jpg,ROI_01,829,386,1107,685,278,299,83122
Social,127.jpg,data/CAT2000/trainSet/Stimuli/Social/127.jpg,ROI_02,1468,531,1595,809,127,278,35306
Social,129.jpg,data/CAT2000/trainSet/Stimuli/Social/129.jpg,ROI_00,831,217,1241,650,410,433,177530
Social,129.jpg,data/CAT2000/trainSet/Stimuli/Social/129.jpg,ROI_01,495,340,737,532,242,192,46464
Social,131.jpg,data/CAT2000/trainSet/Stimuli/Social/131.jpg,ROI_00,873,141,997,329,124,188,23312
Social,131.jpg,data/CAT2000/trainSet/Stimuli/Social/131.jpg,ROI_01,615,111,818,387,203,276,56028
Social,131.jpg,data/CAT2000/trainSet/Stimuli/Social/131.jpg,ROI_02,891,441,1062,646,171,205,35055
Social,133.jpg,data/CAT2000/trainSet/Stimuli/Social/133.jpg,ROI_00,1420,169,1538,325,118,156,18408
Social,133.jpg,data/CAT2000/trainSet/Stimuli/Social/133.jpg,ROI_01,234,158,442,355,208,197,40976
Social,133.jpg,data/CAT2000/trainSet/Stimuli/Social/133.jpg,ROI_02,465,293,608,428,143,135,19305
Social,133.jpg,data/CAT2000/trainSet/Stimuli/Social/133.jpg,ROI_03,949,339,1199,651,250,312,78000
Social,133.jpg,data/CAT2000/trainSet/Stimuli/Social/133.jpg,ROI_04,1458,552,1607,680,149,128,19072
Social,135.jpg,data/CAT2000/trainSet/Stimuli/Social/135.jpg,ROI_00,1156,217,1301,410,145,193,27985
Social,135.jpg,data/CAT2000/trainSet/Stimuli/Social/135.jpg,ROI_01,784,263,967,468,183,205,37515
Social,135.jpg,data/CAT2000/trainSet/Stimuli/Social/135.jpg,ROI_02,1397,344,1536,516,139,172,23908
Social,135.jpg,data/CAT2000/trainSet/Stimuli/Social/135.jpg,ROI_03,289,462,493,642,204,180,36720
Social,135.jpg,data/CAT2000/trainSet/Stimuli/Social/135.jpg,ROI_04,858,485,1174,684,316,199,62884
Social,137.jpg,data/CAT2000/trainSet/Stimuli/Social/137.jpg,ROI_00,683,383,1243,813,560,430,240800
Social,137.jpg,data/CAT2000/trainSet/Stimuli/Social/137.jpg,ROI_01,1194,727,1295,835,101,108,10908
Social,137.jpg,data/CAT2000/trainSet/Stimuli/Social/137.jpg,ROI_02,544,723,667,867,123,144,17712
Social,139.jpg,data/CAT2000/trainSet/Stimuli/Social/139.jpg,ROI_00,1315,447,1493,580,178,133,23674
Social,139.jpg,data/CAT2000/trainSet/Stimuli/Social/139.jpg,ROI_01,811,457,1128,774,317,317,100489
Social,139.jpg,data/CAT2000/trainSet/Stimuli/Social/139.jpg,ROI_02,614,673,807,855,193,182,35126
Social,141.jpg,data/CAT2000/trainSet/Stimuli/Social/141.jpg,ROI_00,721,299,1325,647,604,348,210192
Social,141.jpg,data/CAT2000/trainSet/Stimuli/Social/141.jpg,ROI_01,334,457,468,531,134,74,9916
Social,143.jpg,data/CAT2000/trainSet/Stimuli/Social/143.jpg,ROI_00,1120,265,1273,518,153,253,38709
Social,143.jpg,data/CAT2000/trainSet/Stimuli/Social/143.jpg,ROI_01,739,255,1108,642,369,387,142803
Social,145.jpg,data/CAT2000/trainSet/Stimuli/Social/145.jpg,ROI_00,843,271,1258,646,415,375,155625
Social,145.jpg,data/CAT2000/trainSet/Stimuli/Social/145.jpg,ROI_01,1264,882,1433,996,169,114,19266
Social,147.jpg,data/CAT2000/trainSet/Stimuli/Social/147.jpg,ROI_00,873,121,1160,638,287,517,148379
Social,147.jpg,data/CAT2000/trainSet/Stimuli/Social/147.jpg,ROI_01,923,720,1052,877,129,157,20253
Social,149.jpg,data/CAT2000/trainSet/Stimuli/Social/149.jpg,ROI_00,611,399,728,480,117,81,9477
Social,149.jpg,data/CAT2000/trainSet/Stimuli/Social/149.jpg,ROI_01,794,345,1078,836,284,491,139444
Social,149.jpg,data/CAT2000/trainSet/Stimuli/Social/149.jpg,ROI_02,596,580,747,719,151,139,20989
Social,151.jpg,data/CAT2000/trainSet/Stimuli/Social/151.jpg,ROI_00,1233,151,1409,298,176,147,25872
Social,151.jpg,data/CAT2000/trainSet/Stimuli/Social/151.jpg,ROI_01,701,173,835,332,134,159,21306
Social,151.jpg,data/CAT2000/trainSet/Stimuli/Social/151.jpg,ROI_02,1008,200,1070,310,62,110,6820
Social,151.jpg,data/CAT2000/trainSet/Stimuli/Social/151.jpg,ROI_03,839,199,979,317,140,118,16520
Social,151.jpg,data/CAT2000/trainSet/Stimuli/Social/151.jpg,ROI_04,422,204,566,430,144,226,32544
Social,151.jpg,data/CAT2000/trainSet/Stimuli/Social/151.jpg,ROI_05,890,426,1081,612,191,186,35526
Social,153.jpg,data/CAT2000/trainSet/Stimuli/Social/153.jpg,ROI_00,831,407,1227,636,396,229,90684
Social,153.jpg,data/CAT2000/trainSet/Stimuli/Social/153.jpg,ROI_01,1234,455,1498,633,264,178,46992
Social,155.jpg,data/CAT2000/trainSet/Stimuli/Social/155.jpg,ROI_00,867,210,1376,634,509,424,215816
Social,155.jpg,data/CAT2000/trainSet/Stimuli/Social/155.jpg,ROI_01,344,466,533,663,189,197,37233
Social,157.jpg,data/CAT2000/trainSet/Stimuli/Social/157.jpg,ROI_00,359,223,574,512,215,289,62135
Social,157.jpg,data/CAT2000/trainSet/Stimuli/Social/157.jpg,ROI_01,783,344,1106,628,323,284,91732
Social,157.jpg,data/CAT2000/trainSet/Stimuli/Social/157.jpg,ROI_02,1272,397,1543,623,271,226,61246
Social,159.jpg,data/CAT2000/trainSet/Stimuli/Social/159.jpg,ROI_00,723,185,1234,786,511,601,307111
Social,159.jpg,data/CAT2000/trainSet/Stimuli/Social/159.jpg,ROI_01,429,292,617,500,188,208,39104
Social,161.jpg,data/CAT2000/trainSet/Stimuli/Social/161.jpg,ROI_00,601,235,1118,649,517,414,214038
Social,161.jpg,data/CAT2000/trainSet/Stimuli/Social/161.jpg,ROI_01,1237,412,1441,577,204,165,33660
Social,161.jpg,data/CAT2000/trainSet/Stimuli/Social/161.jpg,ROI_02,1026,684,1131,788,105,104,10920
Social,163.jpg,data/CAT2000/trainSet/Stimuli/Social/163.jpg,ROI_00,474,181,615,333,141,152,21432
Social,163.jpg,data/CAT2000/trainSet/Stimuli/Social/163.jpg,ROI_01,876,425,1221,812,345,387,133515
Social,163.jpg,data/CAT2000/trainSet/Stimuli/Social/163.jpg,ROI_02,883,856,1013,954,130,98,12740
Social,165.jpg,data/CAT2000/trainSet/Stimuli/Social/165.jpg,ROI_00,1123,114,1442,489,319,375,119625
Social,165.jpg,data/CAT2000/trainSet/Stimuli/Social/165.jpg,ROI_01,804,324,1061,644,257,320,82240
Social,165.jpg,data/CAT2000/trainSet/Stimuli/Social/165.jpg,ROI_02,402,327,590,537,188,210,39480
Social,165.jpg,data/CAT2000/trainSet/Stimuli/Social/165.jpg,ROI_03,1453,351,1557,521,104,170,17680
Social,167.jpg,data/CAT2000/trainSet/Stimuli/Social/167.jpg,ROI_00,332,261,660,528,328,267,87576
Social,167.jpg,data/CAT2000/trainSet/Stimuli/Social/167.jpg,ROI_01,1313,370,1491,565,178,195,34710
Social,167.jpg,data/CAT2000/trainSet/Stimuli/Social/167.jpg,ROI_02,860,449,1133,738,273,289,78897
Social,169.jpg,data/CAT2000/trainSet/Stimuli/Social/169.jpg,ROI_00,661,201,794,324,133,123,16359
Social,169.jpg,data/CAT2000/trainSet/Stimuli/Social/169.jpg,ROI_01,831,221,1269,612,438,391,171258
Social,171.jpg,data/CAT2000/trainSet/Stimuli/Social/171.jpg,ROI_00,1280,314,1460,431,180,117,21060
Social,171.jpg,data/CAT2000/trainSet/Stimuli/Social/171.jpg,ROI_01,866,302,1228,635,362,333,120546
Social,171.jpg,data/CAT2000/trainSet/Stimuli/Social/171.jpg,ROI_02,1322,755,1544,905,222,150,33300
Social,173.jpg,data/CAT2000/trainSet/Stimuli/Social/173.jpg,ROI_00,1188,210,1322,391,134,181,24254
Social,173.jpg,data/CAT2000/trainSet/Stimuli/Social/173.jpg,ROI_01,577,235,778,435,201,200,40200
Social,173.jpg,data/CAT2000/trainSet/Stimuli/Social/173.jpg,ROI_02,812,164,1109,642,297,478,141966
Social,175.jpg,data/CAT2000/trainSet/Stimuli/Social/175.jpg,ROI_00,753,123,1186,630,433,507,219531
Social,177.jpg,data/CAT2000/trainSet/Stimuli/Social/177.jpg,ROI_00,666,415,1126,891,460,476,218960
Social,177.jpg,data/CAT2000/trainSet/Stimuli/Social/177.jpg,ROI_01,1234,803,1364,1009,130,206,26780
Social,179.jpg,data/CAT2000/trainSet/Stimuli/Social/179.jpg,ROI_00,405,251,552,426,147,175,25725
Social,179.jpg,data/CAT2000/trainSet/Stimuli/Social/179.jpg,ROI_01,1220,336,1395,517,175,181,31675
Social,179.jpg,data/CAT2000/trainSet/Stimuli/Social/179.jpg,ROI_02,833,339,1198,732,365,393,143445
Social,181.jpg,data/CAT2000/trainSet/Stimuli/Social/181.jpg,ROI_00,1404,162,1614,306,210,144,30240
Social,181.jpg,data/CAT2000/trainSet/Stimuli/Social/181.jpg,ROI_01,999,171,1211,400,212,229,48548
Social,181.jpg,data/CAT2000/trainSet/Stimuli/Social/181.jpg,ROI_02,754,227,962,415,208,188,39104
Social,181.jpg,data/CAT2000/trainSet/Stimuli/Social/181.jpg,ROI_03,882,449,1041,638,159,189,30051
Social,181.jpg,data/CAT2000/trainSet/Stimuli/Social/181.jpg,ROI_04,902,903,1009,962,107,59,6313
Social,181.jpg,data/CAT2000/trainSet/Stimuli/Social/181.jpg,ROI_05,725,970,813,1014,88,44,3872
Social,183.jpg,data/CAT2000/trainSet/Stimuli/Social/183.jpg,ROI_00,1335,318,1521,506,186,188,34968
Social,183.jpg,data/CAT2000/trainSet/Stimuli/Social/183.jpg,ROI_01,827,328,1105,645,278,317,88126
Social,183.jpg,data/CAT2000/trainSet/Stimuli/Social/183.jpg,ROI_02,781,945,855,1009,74,64,4736
Social,185.jpg,data/CAT2000/trainSet/Stimuli/Social/185.jpg,ROI_00,986,37,1122,175,136,138,18768
Social,185.jpg,data/CAT2000/trainSet/Stimuli/Social/185.jpg,ROI_01,1202,186,1344,367,142,181,25702
Social,185.jpg,data/CAT2000/trainSet/Stimuli/Social/185.jpg,ROI_02,892,433,1120,807,228,374,85272
Social,185.jpg,data/CAT2000/trainSet/Stimuli/Social/185.jpg,ROI_03,766,985,832,1024,66,39,2574
Social,187.jpg,data/CAT2000/trainSet/Stimuli/Social/187.jpg,ROI_00,295,250,510,425,215,175,37625
Social,187.jpg,data/CAT2000/trainSet/Stimuli/Social/187.jpg,ROI_01,881,243,1292,610,411,367,150837
Social,187.jpg,data/CAT2000/trainSet/Stimuli/Social/187.jpg,ROI_02,776,938,860,993,84,55,4620
Social,189.jpg,data/CAT2000/trainSet/Stimuli/Social/189.jpg,ROI_00,846,437,1082,724,236,287,67732
Social,189.jpg,data/CAT2000/trainSet/Stimuli/Social/189.jpg,ROI_01,1277,490,1437,694,160,204,32640
Social,189.jpg,data/CAT2000/trainSet/Stimuli/Social/189.jpg,ROI_02,1467,541,1586,693,119,152,18088
Social,189.jpg,data/CAT2000/trainSet/Stimuli/Social/189.jpg,ROI_03,388,621,504,716,116,95,11020
Social,191.jpg,data/CAT2000/trainSet/Stimuli/Social/191.jpg,ROI_00,1650,220,1795,339,145,119,17255
Social,191.jpg,data/CAT2000/trainSet/Stimuli/Social/191.jpg,ROI_01,937,187,1155,388,218,201,43818
Social,191.jpg,data/CAT2000/trainSet/Stimuli/Social/191.jpg,ROI_02,1196,293,1347,414,151,121,18271
Social,191.jpg,data/CAT2000/trainSet/Stimuli/Social/191.jpg,ROI_03,740,285,923,432,183,147,26901
Social,191.jpg,data/CAT2000/trainSet/Stimuli/Social/191.jpg,ROI_04,633,286,730,439,97,153,14841
Social,191.jpg,data/CAT2000/trainSet/Stimuli/Social/191.jpg,ROI_05,572,450,711,576,139,126,17514
Social,191.jpg,data/CAT2000/trainSet/Stimuli/Social/191.jpg,ROI_06,822,433,1126,643,304,210,63840
Social,193.jpg,data/CAT2000/trainSet/Stimuli/Social/193.jpg,ROI_00,692,98,849,251,157,153,24021
Social,193.jpg,data/CAT2000/trainSet/Stimuli/Social/193.jpg,ROI_01,1565,102,1724,267,159,165,26235
Social,193.jpg,data/CAT2000/trainSet/Stimuli/Social/193.jpg,ROI_02,708,272,1056,644,348,372,129456
Social,193.jpg,data/CAT2000/trainSet/Stimuli/Social/193.jpg,ROI_03,307,264,660,458,353,194,68482
Social,193.jpg,data/CAT2000/trainSet/Stimuli/Social/193.jpg,ROI_04,1091,334,1241,444,150,110,16500
Social,195.jpg,data/CAT2000/trainSet/Stimuli/Social/195.jpg,ROI_00,1100,39,1262,320,162,281,45522
Social,195.jpg,data/CAT2000/trainSet/Stimuli/Social/195.jpg,ROI_01,515,343,1070,658,555,315,174825
Social,197.jpg,data/CAT2000/trainSet/Stimuli/Social/197.jpg,ROI_00,1011,88,1176,191,165,103,16995
Social,197.jpg,data/CAT2000/trainSet/Stimuli/Social/197.jpg,ROI_01,670,150,789,266,119,116,13804
Social,197.jpg,data/CAT2000/trainSet/Stimuli/Social/197.jpg,ROI_02,1599,252,1706,350,107,98,10486
Social,197.jpg,data/CAT2000/trainSet/Stimuli/Social/197.jpg,ROI_03,873,448,1149,822,276,374,103224
Social,199.jpg,data/CAT2000/trainSet/Stimuli/Social/199.jpg,ROI_00,712,215,1069,650,357,435,155295
Social,199.jpg,data/CAT2000/trainSet/Stimuli/Social/199.jpg,ROI_01,1098,528,1323,733,225,205,46125
